выплескивать: выплескивать
поездка: поездок
личный: личный
специальный: специальные специальными
только-только: только-только
эфирный: эфирные
новый: новые новое новому нового новых новой
хватать: хватает
поведение: поведение поведения
таблетка: таблетки таблеток
скорректировать: скорректировать
еще: еще
прогулка: прогулкам
любить: любимым любимые любят
снимать: снимают снимать
позаботиться: позаботьтесь
обзор: обзор
эффективный: эффективны
воды: воды
гостиница: гостиницу
доступ: доступа
касаться: касается
пол: пол
аллергия: аллергию
поточить: поточить
человек: люди
а: а
пусть: пусть
в: в
помещение: помещений
выводить: выводить выводите
и: и
к: к
о: о
она: она нее
с: с
средство: средств
у: у
течение: течение
они: них они
дополнительный: дополнительных
уделять: уделяйте уделять
перевезти: перевезти
испуг: испуга
диффузор: диффузор
необходимый: необходимую
входить: входят
расположить: расположите
абсолютно: абсолютно
кормить: кормить
время: время
весной: весной
забыть: забудьте забыли забыть
про: про
кормление: кормление
проблема: проблема
составлять: составляет
также: также
туда: туда
чистый: чистую
обитать: обитает
появиться: появится
получение: получения
растягиваться: растягивается
оставлять: оставляйте
шкаф: шкафы
следовать: следуйте
мебель: мебель
легко: легко
удобно: удобно
вылизывать: вылизывать
надевать: надевайте
присмотр: присмотра
пытаться: пытаться
сначала: сначала
территория: территория
окончание: окончания
воздействовать: воздействуют
какой-либо: какого-либо
требоваться: требуется
закрыть: закрыть
себя: себя
выгуливать: выгуливать
рекомендоваться: рекомендуется
система: системы
полчаса: полчаса
случайно: случайно
рекомендовать: рекомендуем
отзыв: отзыв
распылять: распылять
стабилизация: стабилизации
успокаивать: успокаивающее успокаивающий успокаивающие
постепенно: постепенно
разбросать: разбросанного
купить: купить
пластиковый: пластиковым
один: одна
оценка: оценки
иметь: имейте имеют имеет
снизить: снизить
совет: советы
интересный: интересная
нейтрализовать: нейтрализуя
перенести: перенести
оценить: оцените
часть: часть
практический: практические
возникать: возникает
выпустить: выпустить
инструкция: инструкциям
обезопасить: обезопасить
часто: часто
момент: момента
надеть: надеть
формирование: формированию
некоторые: некоторым некоторые некоторых
помочь: помогут
добраться: добрались
желательно: желательно
процесс: процесса процесс
разрабатываться: разрабатывается
ромашка: ромашки
делать: делать
уборка: уборки уборку
суматоха: суматохе
провод: провода
через: через
воспользоваться: воспользоваться
замена: замена
привыкать: привыкает
подойти: подойти подойдет
приучить: приучена
врач: врачу
складывать: складывать
отдельный: отдельной
запирать: запирайте
поставить: поставить
опасность: опасности
являться: является
бывать: бывает
животное: животных животным животного
из-за: из-за
увеличивать: увеличивая
временить: времени
открывать: открывать
флакон: флакон
облегчать: облегчает
квадратный: квадратных
определиться: определитесь
напряжение: напряжение
группа: группе
переносить: переносить
травмировать: травмировать
это: это этом этого
гулять: гулять
вкус: вкус
депрессия: депрессию
два: двух
смена: смену
ошейник: ошейник
покрытие: покрытия покрытие
вполне: вполне
взять: взяли
стоить: стоит
консультация: консультации
травмироваться: травмироваться
его: его
эффект: эффект
чехол: чехлами
только: только
сантиметр: см
краска: краски
капля: капли
средний: средних
держать: держите
шершавый: шершавой
или: или
зола: зол
настенный: настенные
идеально: идеально
точно: точно
чаща: чаще
протирать: протирайте
почему: почему
особый: особое
быстрый: быстрее
хороший: лучше
спокойный: спокойное
пыль: пыли
окно: окон
испортить: испортить
когда: когда
застелить: застелить
готовиться: готовятся готовиться
играть: играть
учитывать: учитывайте
сыпучий: сыпучие
действие: действия
запереть: заперт
дача: дачи
вещество: вещества
выбраться: выберется выбраться
состояние: состояния
ремонт: ремонт ремонта ремонтом ремонту
работник: работники
приобрести: приобретите
все-таки: все-таки
установка: установка
ваш: вашего вашем вашему вашей ваш
против: против
так: так
плитка: плитка
четвероногий: четвероногих четвероногого четвероного четвероногому
ведь: ведь
где: где
больший: большую
постараться: постараемся постарайтесь
бытовой: бытовую
привыкнуть: привык привыкнуть
предпочтение: предпочтение
неделя: недели
пора: пора
нанять: нанять
товар: товар
выбирать: выбирать выбирайте
быть: быть будет была будете
шерсть: шерсть
бригада: бригаду
тоже: тоже
успокоительный: успокоительное успокоительных успокоительный
есть: есть
вести: вести
оставление: оставления
пластик: пластика
установить: установить
наниматься: нанимаются
мочь: может могут можете
месяц: месяц
этот: этой этот эти
оборудовать: оборудуйте
сам: сам
борьба: борьбе
переехать: переехать
снятие: снятию
друг: друга
спазмолитический: спазмолитическое
тута: тут
вообще: вообще
сохранение: сохранение
выпрыгнуть: выпрыгнули
благотворный: благотворно
кошка: кошка кошку кошки кошек кошке
стресс: стресс стресса
бы: бы
можно: можно
дать: дадим дать дайте
вставить: вставить
покупаться: покупаются
действовать: действует действовать
поселить: поселить
организовать: организуйте организован
смысл: смысл
смочь: смогли сможет
во: во
разлука: разлуку
кошачий: кошачьей
уже: уже
того: того
вы: вас вы вами
оставить: оставьте
ремонтный: ремонтных
проводить: проводить проводите
недооценивать: недооценивайте
обитание: обитания
эмоциональный: эмоционального
просто: просто
нахождение: нахождение
токсический: токсические
розмарин: розмарина
экстракт: экстракты
свое: свои
куда: куда
чтобы: чтобы
проведение: проведения
без: без
перед: перед
шерстить: шерсти
дома: дома
до: до
положить: положите
особенность: особенность
потом: потом
мелкий: мелкой мелких
адрес: адрес
другой: другое
работа: работ работы
давать: давайте давать
рабочий: рабочих
вовремя: вовремя
пар: пары
ее: ее
отдать: отдать
проконсультироваться: проконсультируетесь проконсультируйтесь
собственный: собственный
посол: после
период: период
шум: шума
вычесывать: вычесывайте
повредить: повредит
короткий: короткий
вид: виды
же: же
нижний: нижнюю
попасть: попасть
незаметно: незаметно
влагоустойчивый: влагоустойчивым
керамический: керамическая
что: что чем
масло: масла
длительный: длительном
отдавать: отдавать
за: за
домашние: домашних
котенок: котенка
спрятать: спрячьте
переезд: переезд
дом: дом доме
ожидать: ожидают
брать: брать
растворитель: растворитель
зависеть: зависит
агрессивный: агрессивно
дверь: двери
статья: статье
если: если
метить: метить
родственник: родственникам
любой: любые
избыток: избыток
организм: организма
из: из
наш: наших нашим
естественный: естественным
ранний: ранней
удобный: удобен
их: их
получить: получить
многие: многие
ламинировать: ламинированным
заказ: заказ
розетка: розетку
внутрь: внутрь
игрушка: игрушки
удовлетворять: удовлетворять
коготок: коготки
оказывать: оказывает оказывать
сделать: сделать сделайте сделанного
тщательно: тщательно
влажный: влажными
прочий: прочие
защитить: защитить
меткий: меток
собака: собака собаку собаки собак
упаковка: упаковке
закрываться: закрывались
который: которому которое которые
вывод: выводы
убрать: уберите
токсичный: токсичен
легкий: легче
уведомление: уведомление
крупный: крупных
выбрать: выбрать
страх: страх
вот: вот
экспресс: экспресс
пропустить: пропустить
случай: случае
сразу: сразу
спровоцировать: спровоцировать
плюс: плюс
форточка: форточку
деть: день
вместе: вместе
жить: жить
текстильный: текстильными
несколько: несколько
питомец: питомцев питомца питомец питомцу
отдельно: отдельно
место: место месту местах
начало: началом начала
сохраняться: сохраняется
прозрачный: прозрачными
погулять: погулять
мы: мы
крайне: крайне
перечислить: перечислим
на: на
попытка: попытках
корректировка: корректировки
состав: составе состав
тот: то
не: не
использовать: используемые
выбор: выборе
виниловый: виниловые
каждый: каждый
шлейка: шлейке
указать: укажите
содержать: содержат
кабель: кабели
но: но
поздний: поздней
некуда: некуда
почта: почту
выпускаться: выпускаются
замкнутый: замкнутом
изобретательный: изобретательны
длить: для
начинать: начинайте начинает
площадь: площадь
пустырник: пустырника
об: об
либо: либо
панель: панели
нет: нет
он: он него ему
даже: даже
тревога: тревоги
от: от
проветривание: проветривания
способствовать: способствует способствуют
как: как
внимание: внимание
сталкиваться: сталкиваются
все: все всего
препарат: препараты препарат
помогать: помогают
значительно: значительно
возможность: возможность
по: по
кислота: кислоты
занимать: занимает
безопасный: безопасную безопасен
подготовить: подготовить
доделать: доделать
тихий: тихое
опасный: опасен опасные опасны
порода: породы пород
помещать: помещайте
выводиться: выводится
способ: способ
забывать: забывайте
нервный: нервное нервной
наличие: наличии
переть: при
заранее: заранее
источник: источником
