рекс: рексы рексов рекс
состоять: состоит
отличительный: отличительной
покрыть: покрытые
язва: язвы
стандартный: стандартные
специальный: специальный
адаптированный: адаптирован
новый: новый
образ: образом
газета: газетой
непременно: непременно
любить: любимую
физический: физические физических
гамма: гамме
воды: воды
пить: пить
делиться: делятся
со: со
важный: важно
ушной: ушной
стирать: стирать
полный: полную
нести: несут
а: а
вода: водой
человек: человека
в: в
заболевание: заболевания
содержание: содержания содержание
отборный: отборные
и: и
качественный: качественным
к: к
отменный: отменным
сушеный: сушеные
разговор: разговоре
о: о
подходить: подходящую
ухудшение: ухудшения ухудшение
с: с
она: она нее ей
у: у
передаваться: передаваться
шампунь: шампунь
высыпаться: высыпался
они: они них ними
дополнительный: дополнительными дополнительный дополнительного дополнительные
домик: домик домике
пищевой: пищевой
владелец: владельцы
обращаться: обращайтесь
сила: силах
мир: мире
обеспечить: обеспечив
гигиена: гигиена
отодвигать: отодвигать
необходимый: необходимые необходимый необходимым
ус: усы
поместить: поместить поместите
весьма: весьма
расположить: расположить
привязанность: привязанность
кормить: кормите
развлечь: развлекут
небольшой: небольшими небольшие небольшую
слишком: слишком
корректировать: корректировать
посмотреть: посмотреть
веселый: веселый веселым
кормление: кормления
проблема: проблем
составлять: составлять
порадовать: порадуют
купание: купание купания
также: также
корма: корма корм
чистый: чистой
чистоплотный: чистоплотные
появиться: появится
ниппельный: ниппельной
получение: получения
нежно-розовый: нежно-розового
поддержание: поддержания
делаться: делается
вводить: вводите
самец: самца
сидеть: сидят
симптом: симптомами симптомы
комфортно: комфортно
овес: овес
аллергический: аллергическую
задача: задача
редкий: редкий
пятно: пятна
однако: однако
себя: собой
зерновой: зерновым
рекомендоваться: рекомендуется
лазать: лазать
сквозняк: сквозняков
сгрызать: сгрызают
рекомендовать: рекомендуем
отзыв: отзыв
потребность: потребности
очаровательный: очаровательные
прямая: прямых
один: одном
оценка: оценки
обязательно: обязательно
иметь: имеем имеют иметь
полностью: полностью
мучной: мучного
нос: носа
окрас: окрасу
мера: мере
контролировать: контролировать
оценить: оцените
разграничивать: разграничивают
часть: частях
грибковый: грибковые
класс: класса
сторона: стороне
часто: часто
крепиться: крепится
некоторые: некоторым некоторых
добавляться: добавляются
пересадить: пересадить
избежать: избежать
основа: основу
запустить: запущенных
способность: способностью
способный: способны
кожа: кожу
белка: белка
производить: производите
самочувствие: самочувствии самочувствия
видимый: видимой
развивать: развивающие
качество: качестве
нрав: нрав
гладкий: гладкая
замена: замену
крыса: крыс крысы крысе крысу крыса крысам
взрослый: взрослого
приучить: приучите
отдельный: отдельных
соблюдение: соблюдения соблюдение
встречаться: встречаться
полок: полки полок
должен: должна должен должны
окружать: окружающий
хвойный: хвойных
являться: являются
проводиться: проводиться
лесенка: лесенки лесенок
животное: животному животные животное животного
из-за: из-за
вдоволь: вдоволь
стать: стали
нужно: нужно
разновидность: разновидностей разновидность разновидности
питаться: питается питаться
участить: учащенное
немедленно: немедленно
голый: голые
тренажер: тренажерами тренажеры
порция: порции
металлический: металлическими металлическим
переносить: переносят
это: это этому
ткань: ткани
рост: рост
достойный: достойных достойный достойные
травяной: травяные
координация: координации
стоить: стоит
его: его
неприятный: неприятный
только: только
сантиметр: см
краска: краска
средний: средний среднем
поилка: поилки поилке поилка
коробка: коробки
периодический: периодически
наполнитель: наполнитель наполнителя
или: или
питьевой: питьевой
умственный: умственные
генетика: генетикой
точно: точно
чаща: чаще
теплый: теплое теплом
глазок: глазки
забраться: забраться
воздействие: воздействия
подозрение: подозрениях
минимум: минимум
уход: уход уходу
многообразие: многообразие
хороший: хорошей лучше
спокойный: спокойный
аквариум: аквариума
много: более
завернуть: заверните
когда: когда
профилактика: профилактики
вкусный: вкусные
некроз: некроз
обычный: обычных
затем: затем
нарушение: нарушение
болезнь: болезнь болезни
зверек: зверьки зверьку зверька
остановиться: остановимся
актиномикоз: актиномикоз
промокнуть: промокните
продлить: продлить
норма: норм
перешагнуть: перешагнуть
выполнить: выполнен
перекармливать: перекармливать
появляться: появляются
мягкий: мягкая мягкий мягко
заполнить: заполнить заполните
пневмония: пневмония
паразитарный: паразитарное
ваш: вашей ваш
так: так
подвижной: подвижным
присутствовать: присутствует присутствовать
рекомендация: рекомендации
ведь: ведь
больший: больше
основание: основании
выделение: выделения
активный: активный активные
потребоваться: потребуется
предпочтение: предпочтение
привыкнуть: привыкли
реакция: реакцию
самый: самых самая
всеять: всей
материал: материалы материалов
товар: товар
быть: быть будет было
прут: прутьями
шерсть: шерсть
волосок: волоски
отмечать: отмечают
белковый: белковую
распределить: распределите
есть: есть
пахнуть: пахнет
злак: злаки
прерывистый: прерывистое
покраснение: покраснение
мочь: может мог могут
дыхательный: дыхательных
этот: этих эти
оборудовать: оборудуйте оборудована
пищеварительный: пищеварительных
объем: объем
интеллект: интеллектом
друг: друзьями друг друга
плохо: плохо
мила: милой
вирусный: вирусное
основной: основной основные основными
застилать: застилать
кокцидиоз: кокцидиоз
бы: бы
поддон: поддон
можно: можно
применение: применению
основное: основном
минерал: минералы
возможный: возможен
организовать: организовать
минимальный: минимальное
элемент: элементам элементы
позволить: позволит
вес: вес
готовый: готовые готовый
раз: раз
цвет: цвет
вы: вы вас
остаток: остатки
оставить: оставьте
курчавый: курчавая
солнечный: солнечных
цель: целью
необходимо: необходимо
дерево: дерева
регулярный: регулярные
свой: своей
носик: носик
пушок: пушок
радовать: радовал
свое: своем
требование: требований
тем: тем
популярный: популярные популярны
чтобы: чтобы
рацион: рацион
дикий: диких
без: без
между: между
до: до
слегка: слегка
гармоничный: гармоничного
особенность: особенностью
ежедневный: ежедневном
адрес: адрес
другой: другой
чистка: чистка
клетка: клетка клетки клетку
давать: давайте
введение: введение
окрасить: окрашены
ее: ее
полотенце: полотенцем
подвесить: подвесить
исток: истоков
питание: питания питании питание
посол: после
сухой: сухом
причина: причины
вид: видах виду
производиться: производятся
грызун: грызунов грызуны грызун грызуна
бесшерстный: бесшерстные
дно: дно
семечко: семечек
ингредиент: ингредиенты
сбалансированный: сбалансированный сбалансированным
надежно: надежно
купать: купать
керамический: керамические
что: что чем
фрукт: фрукты
подверженный: подвержены
отдавать: отдавайте
за: за
тип: типа
домашние: домашние домашних
указывать: указывают
форма: формы
ожидать: ожидают
приручение: приручения
нерегулярный: нерегулярных
растительный: растительная
онкологический: онкологические
гамак: гамак
оттопырить: оттопыренные
если: если
бортик: бортиками
захотеть: захочет
любой: любые
отличаться: отличаются отличающиеся
типографский: типографская
из: из
ветеринарный: ветеринарную ветеринарного ветеринарному
неконфликтный: неконфликтные
бумага: бумагой
удобный: удобнее
их: их
бактериальный: бактериальное
получить: получить
складчатый: складчатую
заказ: заказ
деревянный: деревянные
игрушка: игрушки
удовлетворять: удовлетворять
следить: следите
около: около
сделать: сделаны
тщательно: тщательно
различный: различный различные различных
заметить: заметили
заниматься: заниматься
здоровье: здоровья здоровьем
транспортировка: транспортировка
просовываться: просовывается
верный: верными
белков: белковым
керамик: керамики
стоять: стояли
ежедневно: ежедневно
ручной: ручных
жидкость: жидкость
симптоматика: симптоматика
обратиться: обратитесь
клиника: клинику
малыш: малыша
потеря: потеря
решить: решили
который: которые которого которое
ухаживать: ухаживать
вывод: выводы
мордочка: мордочке
поэтому: поэтому
крупный: крупная крупные
участок: участки
расстояние: расстояние
любимец: любимец любимцам любимцу любимца
неподходящий: неподходящих
сальмонеллез: сальмонеллез
располагать: располагайте
пища: пища
грушевидный: грушевидной
выбрать: выбрать
сегодня: сегодня
хорошо: хорошо
случай: случаях
температура: температура
такой: такие таким таком
удалять: удаляйте
подвесной: подвесные
привязываться: привязываться
жить: живут
вод: воду
нужный: нужны нужен
облегчить: облегчит
питомец: питомец питомцу питомца
оптимальный: оптимальный оптимальная
располагаться: располагаются
решение: решений
широкий: широкие
мы: мы
ввиду: ввиду
разрешение: разрешения
на: на
состав: составе составы
водный: водные
тот: то
комплекс: комплексы
не: не
использовать: использовать используйте
каждый: каждая каждому
наиболее: наиболее
указать: укажите
кукурузный: кукурузный
блестеть: блестящими
миска: миски мисок миска
содержать: содержит
одомашнивание: одомашниванием
маленький: меньше маленькой малейших
но: но
почта: почту
вызвать: вызвать
внешний: внешним
емкость: емкость
длить: для
животный: животный
модель: модели
цветовой: цветовых
увеличиваться: увеличиваются
заменять: заменять
нет: нет
опилка: опилки
корм: кормом
бок: бокам
редко: редко
он: него он
развитие: развитию
даже: даже
показание: показаниями
от: от
сфинкс: сфинкс
сон: сна сон
избегать: избегайте
первое: первыми
как: как
все: все всего всем
условие: условиях условий условия
тельце: тельцем
добывать: добывать
насчитываться: насчитывается
по: по
оснастить: оснащен
устойчивый: устойчивы
бисквит: бисквиты
приучать: приучать
безопасный: безопасны безопасного
впитывать: впитывают
склонный: склонны
подготовить: подготовьте
самка: самки
санитарно-гигиенический: санитарно-гигиенических
опасный: опасным
шерстка: шерстки
навесный: навесные
порода: пород
способ: способ
высокий: высокие высокими высшего высоким
забывать: забывайте
обратный: обратной
наличие: наличием наличии
признак: признакам
достигать: достигать
переносок: переноска
переть: при
источник: источника
печение: печенья
