долгий: долго
состоять: состоит
покрыть: покрыто
специальный: специальных
раздражение: раздражение
новый: новое
найти: найти
жуткий: жуткий
невероятный: невероятный
еще: еще
прогулка: прогулок прогулке
рот: рот
любить: любимого
эффективный: эффективных
подцепить: подцепить
лапа: лапах
со: со
пить: пить
высиживание: высиживания
менее: менее
важный: важна
живот: живот
полный: полным полном
встретить: встретить
жертва: жертвы жертву жертва
а: а
человек: человека людей
в: в
зудеть: зудящих
лес: лесу
и: и
к: к
показывать: показывает
подходить: подходящего
о: о
вероятность: вероятностью вероятность
переносчик: переносчиками
с: с
средство: средств средства средствам
хитиновый: хитиновым
у: у
применять: применяют
определить: определенным
течение: течение
шампунь: шампуни
область: области
клещ: клещи клещей клеща клещ
они: они
знакомый: знаком
сезон: сезона сезон
наступление: наступлением
оно: оно
обеспечить: обеспечить
небольшой: небольшой
время: время
птичий: птичьих
сильный: сильные сильный
проблема: проблемой
присоединиться: присоединились
составлять: составляет
также: также
вблизи: вблизи
чистый: чистая
обитать: обитают
появиться: появится
наружное: наружных
получение: получения
комплексный: комплексную
мебель: мебель
водоем: водоемов
шанс: шансов
трава: траве
находиться: находятся
собачий: собачьи
самец: самцов
света: свет
симптом: симптом
рогатый: рогатый
обеспечивать: обеспечивают
однако: однако
рекомендовать: рекомендуем
отзыв: отзыв
действенный: действенны
городской: городские
лайм: лайма
один: одной
оценка: оценки
обязательно: обязательно
иметь: имеют
откладывать: откладывает
длина: длина длину
оценить: оцените
чесаться: чешется
выход: выход
практический: практически
эктопаразит: эктопаразитов
класс: классу
минута: минуты
активность: активность
повреждать: повреждают
момент: момент
лето: летом
часто: часто
верхний: верхней
некоторые: некоторых
частый: частого
укус: укусы укусов укусам
помимо: помимо
обувь: обуви
парнокопытный: парнокопытных
плюсовой: плюсовой плюсовая плюсовую
процесс: процессе
кожа: кожа
обработать: обработать
среди: среди
качество: качестве
конечность: конечности конечностях
через: через
меньший: меньшее
атака: атаки
взрослый: взрослые взрослой
столько: столько
становиться: становятся
спина: спине
доставлять: доставляют
особенно: особенно
встречаться: встречающимися встречаются
большой: велика
подкласс: подклассу
микроскопический: микроскопический
опасность: опасность
являться: являются
параллельно: параллельно
заразить: заразить заражённое
животное: животных животного
длиться: длится
зона: зоне
упругий: упругая
повторный: повторного
обладать: обладает
стать: стал стать
питаться: питаются питающиеся
вызывать: вызывают
группа: группе
это: это этим
прочный: прочно
большинство: большинство
гулять: гуляет
обнаружить: обнаружено обнаружить
ошейник: ошейников ошейники
прыжок: прыжок
стоить: стоит
его: его
цикл: цикл цикла
неприятный: неприятные неприятная
только: только
сантиметр: см
капля: капель капли
заражение: заражения
линька: линек
или: или
поджидать: поджидать поджидает
отличие: отличие
жучков: жучков
относиться: относятся относится
особь: особи
чаща: чаще
защита: защита защиту защиты
теплый: теплое теплый
хватательный: хватательные
нимфа: нимфы
случаться: случается
особый: особое
хороший: лучшая лучший
много: много более
окно: окном
грудь: груди
когда: когда
профилактика: профилактика профилактику
атаковать: атакуют
общий: общие общий общая
болезнь: болезни
первый: первой
заразиться: заразиться
осень: осенью
мягкий: мягкую
хвататься: хвататься
произвести: произвести
против: против
ваш: вашего вашей ваш
именно: именно
так: так
главное: главное
четвероногий: четвероного
больший: больше
где: где
активный: активны
неделя: недели
самый: самыми
всеять: всей
эволюция: эволюции
товар: товар
выбирать: выбирают выбирает
шерсть: шерсть
мимо: мимо
отряд: отряду
паукообразный: паукообразных
яйцо: яйца
черный: черная
кровососущий: кровососущие кровососущих кровососущий
район: районе
мочь: может могут
попадать: попадают
этот: эти этих
активизироваться: активизируются
борьба: борьбе
объем: объеме
дорожка: дорожках
протяжение: протяжении
сохранение: сохранения
кошка: кошек
кокон: кокона
стресс: стресса
можно: можно
воздух: воздуха
оружие: оружие
смочь: смогли
аппетит: аппетита
во: во
кошачий: кошачьи
наступать: наступает
своевременный: своевременная
больной: больным больного
того: того
вы: вы
оставить: оставьте
волна: волны
необходимо: необходимо
крыло: крылья
регулярный: регулярная
свой: своей свою
выделить: выделить
свое: своего своими
густой: густой
чтобы: чтобы
пребывание: пребывания
без: без
шерстить: шерсти
утратить: утратили
до: до
особенность: особенность
мелкий: мелкие мелких
адрес: адрес
другой: других другими
оставаться: остаётся
характеристика: характеристика
черта: черты
ее: ее
держаться: держаться держится
пока: пока
посол: после
профилактический: профилактические
заполучить: заполучить
число: числа
причина: причин
жаркий: жарким
цельный: цельное
вид: видов виды виде
же: же
подошва: подошве
грызун: грызунов
надежно: надежно
путь: пути
что: что чем
светлый: светлая
погодный: погодных
зуд: зуд
за: за
домашние: домашних
паразит: паразиту паразитами паразитов
домашний: домашнего
возобновлять: возобновляют
приусадебный: приусадебные
ожидать: ожидают
поверхность: поверхности
телец: тельца тельце
разделить: разделено
спрятаться: спрятаться спрячется
настоящее: настоящее
если: если
любой: любой любое
отличаться: отличаются
осматривать: осматривать осматривайте
из: из
временной: временной
явный: явный
серьезный: серьезных
кусать: кусает кусают
бескрылый: бескрылых
их: их
вопреки: вопреки
насекомое: насекомые насекомым насекомого насекомых насекомое
контакт: контакте
объединить: объединили объединить
заказ: заказ
термометр: термометр
около: около
оказывать: оказывают
сделать: сделать
тщательно: тщательно
связанный: связан
водиться: водятся
тело: тела теле телу
здоровье: здоровья
обращать: обращая обращайте
испытывать: испытывает
здоровый: здорового
год: лета
распространить: распространенными распространенному
избавление: избавлении
защитить: защитить
жизненный: жизненный жизненного
непосредственный: непосредственном
лечение: лечением
ползать: ползать
передвигаться: передвигаться
потеря: потери
который: которой которые которого которых
постоянный: постоянное
вывод: выводы
поэтому: поэтому
холка: холку
крупный: крупный крупных
любимец: любимец
следующий: следующими следующих
весна: весны
температура: температура температуры
такой: таким
жить: живет жить
ночной: ночная
тенистый: тенистых
несколько: нескольких
питомец: питомцев питомец питомца
место: местах места
начало: начала
кожный: кожный
строение: строении строения строением
проходить: проходя
мы: мы
на: на
тот: тех то
не: не
использовать: использовать
каждый: каждое каждой
наиболее: наиболее
задний: задних
эластичный: эластичная
указать: укажите
расти: расти
кровь: кровью кровь
газон: газоны
но: но
маленький: маленьких
почта: почту
выпускаться: выпускаются
внешний: внешних
длить: для
ученый: ученые
начинать: начинают начинать начинает
независимо: независимо
количество: количество
прилипать: прилипая
увеличиваться: увеличиваться
личинка: личинки
нет: нет
бок: боков
он: он
развитие: развития
тысяча: тысяч
поиск: поисках
даже: даже
от: от
статистика: статистика
блоха: блохи блох блохами
как: как
внимание: внимание
все: все всех
помогать: помогают
возможность: возможность
насчитываться: насчитывается
кормиться: кормится
по: по
стадий: стадиях стадии
уникальный: уникальными
сжатый: сжатое
самка: самок самка
опасный: опасные опасными
постоянно: постоянно
риск: риска
одежда: одежде
очень: очень
упасть: упавшие
способ: способ
высокий: высокой
забывать: забывать
какой: какие
наличие: наличии
достигать: достигает
активно: активно
переть: при
