долгий: долго
яйцо: яйца
день: дней
есть: есть
лечиться: лечится
еще: еще
болеть: болеют
провоцировать: провоцируют
мочь: могут может
попадать: попадают
этот: эти этой этих
сам: сами сама
со: со
сосать: сосать
пироплазмоз: пироплазмоз
предел: пределов
полный: полной
а: а
человек: человеку человек
в: в
основной: основные
заболевание: заболевание заболевании
гельминт: гельминты
кошка: кошку
и: и
допрыгивать: допрыгивать
летальный: летальный
воздух: воздуха
можно: можно
о: о
основное: основном
подходить: подходящие
с: с
переносчик: переносчиками
она: она ней
средство: средства
у: у
передаваться: передается передаваться
клещ: клещи клещ клеща
они: они им
подниматься: поднимается
наступать: наступает
готовый: готовы
своевременный: своевременной
аскарида: аскариды
уже: уже
снижение: снижение
характеризоваться: характеризуется
раз: раз
того: того
вы: вас
оставить: оставьте
этаж: этажей
исход: исход
просто: просто
быстро: быстро
регулярный: регулярных
снижать: снижают
разрушать: разрушают
лечить: лечить
внутренний: внутренних внутренние
погладить: погладив
обычно: обычно
сильный: сильный
проблема: проблемы проблем
причинить: причинить
также: также
противопаразитарный: противопаразитарный
появиться: появятся появится
получение: получения
без: без
легко: легко
до: до
надевать: надевать
потом: потом
адрес: адрес
вред: вред
другой: других
отпугивать: отпугивать
редкий: редкой
подхватывать: подхватывает
посол: после
центральный: центральная
случайно: случайно
присасываться: присасывается
отказ: отказ
отзыв: отзыв
вид: вида
же: же
подошва: подошве
лайм: лайма
оценка: оценки
всегда: всегда
блошиный: блошиный
энцефалит: энцефалит
что: что чем
предмет: предметах
оценить: оцените
лептоспироз: лептоспироз
паразит: паразиты паразитами
ожидать: ожидают
лето: летом
верхний: верхних
некоторые: некоторых
если: если
существовать: существует
укус: укусов
инфекция: инфекции
протекать: протекает
тереть: три
укусить: укусила
любой: любых любые
организм: организм организма
из: из
переползти: переползти
способный: способны
видимый: видимых
их: их
многие: многие
контакт: контакте
через: через
зрение: зрением
заказ: заказ
повышение: повышением
дерматит: дерматит
крыса: крысы
результат: результате
тело: телу теле
мышь: мыши
уличный: уличной
являться: являются
здоровый: здоровый
заразить: заразить заразив
покидать: покидает
проглотить: проглотить проглотит
животное: животным животное животного
из-за: из-за
поселяться: поселяясь поселяются
пакет: пакетах
увеличение: увеличением
кустарник: кустарниках
характерный: характерны
поражаться: поражаются
стать: станет
который: которая которые который
поэтому: поэтому
легкий: легче
лимфатический: лимфатических
вызывать: вызывая вызывают вызываемые
переносить: переносят
травмировать: травмируют
следующий: следующих
это: это этого этом
родной: родной
ткань: тканях
рассказать: расскажем
сильнейший: сильнейшую
температура: температура температуры
острый: острая
его: его
вместе: вместе
жить: живут
питомец: питомец питомца
заражение: заражения
или: или
допустить: допустить
мы: мы
перечислить: перечислим
на: на
не: не
ранка: ранки
использовать: используйте
облегчение: облегчения
указать: укажите
хороший: лучше
но: но
почта: почту
когда: когда
появление: появление
длить: для
обрабатывать: обрабатывать
начинать: начинает
увеличиваться: увеличивается
принести: принеся
орган: органах
болезнь: болезни болезнь
перепрыгнуть: перепрыгнуть
он: он него
развитие: развитие
заразиться: заразиться
даже: даже
от: от
тогда: тогда
блоха: блохи блох
как: как
размер: размерах
все: все всему всего
глист: глисты глистов глистами
помогать: помогает
ваш: вашей ваш
устранить: устранить
по: по
проникнуть: проникнуть
передавать: передает
где: где
интоксикация: интоксикацию
активный: активный
хромота: хромотой
опасный: опасные опасна
очень: очень
проникать: проникают
способ: способ
высокий: высокой выше
нервный: нервная
забывать: забывайте
товар: товар
какой: какие
наличие: наличии
быть: будет
печень: печень
активно: активно
переть: при
шерсть: шерсть
печение: печенью
