приводить: приводит
специальный: специальным
комар: комары комаров
день: дней
еще: еще
гибнуть: гибнет
ребенок: детей дети
эффективный: эффективное
попросить: попросить
со: со
касаться: касается
важный: важно
ушной: ушных ушными
содержимое: содержимого
юридический: юридический
пол: полы
перчатка: перчатках
аллергия: аллергии
а: а
человек: людей
вода: водой
б: б
в: в
заболевание: заболеваниям заболевание
подробный: подробнее
помещение: помещении помещение
реклама: реклама
содержание: содержание
и: и
к: к
показывать: показывает
о: о
подходить: подходит
с: с
она: нее она
переносчик: переносчиками
средство: средство средством
у: у
применять: применять
течение: течение
лекарство: лекарства лекарствами
область: области область
они: они ним ими них
сезон: сезона
клещ: клещами
этаж: этажах
препятствовать: препятствует
расположить: расположены
абсолютно: абсолютно
медучреждение: медучреждение
быстро: быстро
время: время
забыть: забудьте
бесцветный: бесцветного
жила: жил
ооо: ооо
внутренний: внутренними
идентичный: идентичен
простота: простоту
раствор: раствор
также: также
индивидуальный: индивидуальную
появиться: появится
получение: получения
следовать: следует следуйте
час: часа
прием: прием
легко: легко
написать: напишем
лактация: лактации
степень: степени
постирать: постирать
вред: вред
мазать: мазать
вложить: вложена
окончание: окончаний окончания
симптом: симптомы
инна: инн
требоваться: требуется
редкий: редких
повышать: повышает
спирт: спирт
мышца: мышцах
устанавливать: устанавливать
предназначить: предназначена
дрожь: дрожь
офис: офис
рекомендоваться: рекомендуется
система: системе
далекий: подальше
переезжать: переезжаете
рекомендовать: рекомендованную рекомендуем
отзыв: отзывы отзыв
прямая: прямых
один: одним одно одна одного одну
оценка: оценки
сопротивляться: сопротивляться
оттенок: оттенка
обязательно: обязательно
совет: совет
посетить: посетите
лактон: лактонов
хлор: хлора
оценить: оцените
эфир: эфир
удваивать: удваивайте
последний: последнюю
волокно: волокна
московский: московская
минута: минут
активность: активности
инструкция: инструкцию инструкцией
мыльный: мыльной
лето: летом
верхний: верхних
выписать: выпишет
добраться: добраться
тереть: три
описание: описание
ничто: ничем
истечение: истечении
способный: способен способны
кожа: кожу
хранить: хранить
обработать: обработать
ежемесячно: ежемесячно
градус: градусов
качество: качестве
преимущество: преимущества
через: через
взрослый: взрослых
крыса: крыс
врач: врач
превышать: превышать
соблюдение: соблюдении
назначить: назначит
должен: должна
являться: является являются
заразить: заразить
покидать: покидает
животное: животных животного животное животные
бутить: бутил
эффективность: эффективность
весомый: весом весомых
нужно: нужно
достаточно: достаточно
выкидывать: выкидывайте
возможно: возможно
немедленно: немедленно
группа: группам группе группы
провести: проведите
переносить: переносят
это: это этом этого
обработка: обработки обработка обработку обработкой
удобство: удобства
прямой: прямого
кой: коем
привлекать: привлекайте
консультация: консультации
его: его
эффект: эффект эффектов эффекты
симптоматический: симптоматической
только: только
остальное: остальном
ветеринар: ветеринара ветеринару
капля: капли капель каплям каплей
средний: средней
пипетка: пипетки пипетка пипетку
нельзя: нельзя
токсичность: токсичности токсичность
заражение: заражения
коробка: коробку
или: или
возраст: возраста
относиться: относятся относится
вспомогательный: вспомогательных
подсказать: подсказать
протирать: протирать
уход: уходе
особый: особей особом
хороший: лучше
наносить: наносить
много: много
окно: окна
когда: когда
профилактика: профилактики
значит: значит
обычный: обычную
нарушение: нарушению
действие: действия
разрешить: разрешено
первый: первую
вещество: вещество веществ вещества
всасываться: всасывается
слабый: слабый
повсюду: повсюду
луч: лучей
компания: компанией
мембрана: мембран
ошибиться: ошибиться
против: против
крышка: крышкой
ваш: вашей ваш
проход: проходов
так: так
многоэтажный: многоэтажные
рекомендация: рекомендации
ведь: ведь
возникнуть: возникнуть
больший: больше
где: где
срок: срок срока
ион: ионам
выделение: выделение
дальнейший: дальнейшей
потребоваться: потребуется
распространение: распространению
использование: использования
неделя: недель
товар: товар
выбирать: выбирайте
быть: были быть будет будете будут
колпачок: колпачка
шерсть: шерсть
отмечать: отмечают
яйцо: яиц яйца
дозировка: дозировку дозировок дозировка дозировке дозировкой
темный: темном
есть: есть
пахнуть: пахнет
мочь: может могут
месяц: месяца месяц
попадать: попадать
этот: этих
сам: самого сам сами
борьба: борьбы
объем: объем
вскрыть: вскрытую
друг: друг друга
ближний: ближайшие
гельминт: гельминтов
смыть: смыть
схема: схеме
прочитать: прочитайте
прописать: прописал
летальный: летальный
совмещение: совмещения совмещение
применение: применения применению
можно: можно
рекламодатель: рекламодатель
дать: дайте
действовать: действующее действует
метиловый: метиловый
смочь: смогут сможет
во: во
уже: уже
извинить: извините
раз: раз
прыгать: прыгают
цвет: цвет
вы: вас вы
оставить: оставьте
исход: исход
солнечный: солнечных
соблюдать: соблюдать
специалист: специалист
побочный: побочных побочные
рвота: рвота
регулярный: регулярная
снижать: снижает
сутки: сутки
щенок: щенков щенки
ветврач: ветврачом ветврача
убедиться: убедитесь
тем: тем
куда: куда
популярный: популярных
чтобы: чтобы
противопаразитарный: противопаразитарный противопаразитарными
здесь: здесь
проведение: проведению
перед: перед
дома: дома
до: до
погибать: погибают
нуждаться: нуждаются
особенность: особенностях
годность: годности
адрес: адрес
другой: других другой другие другими
работа: работе
оставаться: оставаться
передача: передаче
ее: ее
проконсультироваться: проконсультируйтесь
терапия: терапии
макроциклический: макроциклических
иначе: иначе
посол: после
сухой: сухом сухая
защищать: защищать
период: период
превысить: превысить
усиливать: усиливать
центральный: центральной
вид: виде
кроме: кроме
же: же
влага: влаги
грызун: грызуна
вымыть: вымыть
двигаться: двигаться
попасть: попасть
купать: купать
что: что
за: за
паразит: паразитами паразитов паразита
удовольствие: удовольствием
котенок: котята котенка котятам котят котенок
дом: доме
ожидать: ожидают
поверхность: поверхности
очередной: очередной
процедура: процедуры процедуру
статья: статье
если: если
справляться: справляется
родственник: родственников
повод: поводу
организм: организм
из: из
изопропиловый: изопропиловый
ветеринарный: ветеринарного
случайный: случайного
серьезный: серьезный
лиловый: лиловой
внутри: внутри
их: их
контакт: контакта
компонент: компонентам
насекомое: насекомых
заказ: заказ
повышение: повышение
резвиться: резвятся
покупка: покупке
доза: дозу доза
следить: следите
тщательно: тщательно
различный: различным
квартира: квартиру квартиры
здоровье: здоровью
нанести: нанести
неокрепший: неокрепший
проницаемость: проницаемость
разный: разный
совмещать: совмещать
желтоватый: желтоватого
кг: кг
год: года
защитить: защитить
жидкость: жидкость
обратиться: обратитесь обратиться
упаковка: упаковке упаковкой
лечение: лечения
резкий: резкое
малыш: малыша малышами малышам
беременная: беременных
прекрасно: прекрасно
который: которое которых которые которая которую
вывод: выводы
поэтому: поэтому
холка: холку
следующий: следующее следующий следующие
гудков: гудкова
ли: ли
вещь: вещи
уничтожать: уничтожает
рассказать: расскажем
повышенный: повышенное
пропустить: пропустили
хорошо: хорошо
случай: случае случаях
сразу: сразу
температура: температуре
спровоцировать: спровоцировать
такой: такое такого
плюс: плюсов
вместе: вместе
питомец: питомца питомцами питомцев
безопасно: безопасно
начало: начала
место: места месте
сохраняться: сохраняется
регион: регион
проходить: проходит
сетка: сетки
противопоказание: противопоказаниям противопоказания
мы: мы
на: на
состав: составе
тот: том те то той
не: не
использовать: используйте использовать
каждый: каждой
ни: ни
указать: укажите
кровь: крови
но: но
маленький: меньше маленького
почта: почту
нанесение: нанесения
выпускаться: выпускается
внешний: внешними внешних
появление: появлении появление
длить: для
обрабатывать: обрабатывайте
количество: количество количества
содержаться: содержатся
личинка: личинки личинок
механизм: механизм
обратить: обратите
вскрытие: вскрытия
он: он него
даже: даже
показание: показания
от: от
антигистаминный: антигистаминные
бегать: бегают
избегать: избегайте
блоха: блох блохи блохами
как: как
внимание: внимание внимании
все: всего все
препарат: препарат препаратов препарате препаратом препарата препараты препаратами
глист: глисты глистов глистами
проглатывание: проглатывания
по: по
разовый: разового
слюна: слюны
жуковский: жуковский
немой: нем
опасный: опасное
риск: риска рисков
очень: очень
способ: способ
высокий: высоко
нервный: нервных нервные нервной
какой: какими какого какая
наличие: наличии
переть: при
переноситься: переносится
