дозировка: дозировках дозировки дозировку
таблетка: таблетки
внимательно: внимательно
еще: еще
учет: учетом
кровососущий: кровососущих
позаботиться: позаботьтесь
эффективный: эффективно эффективны
мочь: могут может
месяц: месяцев
любимица: любимицей
этот: эти
со: со
борьба: борьбы
важный: важные важно
касаться: касается
определяться: определяется
под: под
свидетельствовать: свидетельствовать
расстройство: расстройство
множество: множество
а: а
в: в
иммунитет: иммунитет
гельминт: гельминты гельминтов
отправляться: отправляются
кошка: кошек
и: и
к: к
можно: можно
о: о
подходить: подходит
переносчик: переносчиками
с: с
средство: средство средств средства
у: у
действовать: действуют
применять: применяют
клещ: клещи клещей
они: они ними
производитель: производители
уже: уже
пройти: пройти
того: того
вы: вы
оставить: оставьте
смертельный: смертельных
проводить: проводят
беспокойный: беспокойное
клинический: клинического
кормить: кормящим
время: время
регулярный: регулярная
выходить: выходит
щенок: щенка щенок щенков щенкам
поражать: поражать
ветврач: ветврачи ветврачом
сильный: сильный
главный: главный
вялость: вялость
встретиться: встретится
густой: густой
чтобы: чтобы
также: также
появиться: появится
получение: получения
до: до
прием: приема
надевать: надевать
сначала: сначала
степень: степенью
мелкий: мелких
адрес: адрес
симптом: симптомы
весить: весит
увидеть: увидели
оставаться: остаются
давать: дают давать
передача: передачи
дискомфорт: дискомфорт
отсутствие: отсутствие
регулярно: регулярно
однако: однако
последствие: последствий
посол: после
защищать: защищают защищает
рекомендоваться: рекомендуется
читать: читайте
тяжелый: тяжелой
черви: черви
контроль: контролем
беременность: беременности
заподозрить: заподозрить
отзыв: отзыв
вид: видов
повреждение: повреждения
оценка: оценки
незаметно: незаметно
что: что
править: правило
оценить: оцените
домашние: домашним
паразит: паразитов паразиты
указывать: указывают
форма: формы
ожидать: ожидают
отпугивание: отпугивания
показатель: показатели
труд: трудом
если: если
укус: укусы
размножаться: размножаются
организм: организме организм
кожа: кожи
делать: делайте делаем
ветеринарный: ветеринарного
ошибочно: ошибочно
производить: производят
среди: среди
их: их
выдерживать: выдерживает
заказ: заказ
внутрь: внутрь
взрослый: взрослых
жизненно: жизненно
результат: результатах
особенно: особенно
здоровье: здоровьем
анализ: анализа
оживать: оживают
неокрепший: неокрепшим неокрепший
далее: далее
разный: разные разных разной
назначать: назначают
новорожденный: новорожденного
являться: являются
диспансеризация: диспансеризацию
бледный: бледные
год: года
из-за: из-за
защитить: защитить
собака: собак собакам
лечение: лечения
резкий: резкое
круглый: круглыми
малыш: малыши малыш малышей
младший: младше
интерес: интереса
беременная: беременным
нестерпимый: нестерпимую
который: которые
вывод: выводы
поэтому: поэтому
избавиться: избавиться
выведение: выведения
холка: холку
группа: группе
следующий: следующим
обработка: обработка обработки обработке обработку
это: это
большинство: большинство
ошейник: ошейник
выбрать: выбрать
ограничить: ограниченным
случай: случае
консультация: консультации
его: его
иметься: имеющихся
деть: день
только: только
жизнь: жизни
рассказывать: рассказываем
скулить: скулит
капля: капли
несколько: несколько
питомец: питомцам
улица: улицу
заражение: заражении заражения
мы: мы
слизистая: слизистые
разрешение: разрешения
на: на
защита: защиту защиты
не: не
использовать: используют использовать
выбор: выборе
советоваться: советуйтесь
барс: барс
указать: укажите
кровь: крови
распознавать: распознаем
маленький: меньше
наносить: наносить
много: более
но: но
почта: почту
форте: форте
боль: боль
когда: когда
профилактика: профилактики
внешний: внешней
ленточный: ленточными
длить: для
учесть: учесть
начинать: начинают начиная начинаем начинайте
об: об
личинка: личинки
список: списком
разрешить: разрешенных разрешено
первый: первой первую
масса: массы
заразиться: заразиться
поиск: поиски
от: от
длинный: длинной
деятельность: деятельность
блоха: блохами блох
причинять: причиняют
как: как
все: все
препарат: препаратов препараты препарата препарат
глист: глистов
помогать: помогают
ваш: вашей ваш
главное: главное
так: так
старший: старше
по: по
плохой: плохой
самка: самкам
опасный: опасных опасны
постоянно: постоянно
риск: риска
неделя: недель
порода: пород
способ: способ
высокий: высокие
какой: какое
товар: товар
наличие: наличие наличии
выбирать: выбирайте выбираем
быть: будет
активно: активно
источник: источник
переть: при
шерсть: шерстью
