красочный: красочный
аквариумный: аквариумных аквариумное аквариумного
гниение: гниение
состоять: состоят
специальный: специальных
жесткость: жесткость
темный: темном темных темные
нейтральный: нейтральны нейтральные
неплохо: неплохо
еще: еще
лишний: лишней
гамма: гамму
нетоксичный: нетоксичных
этот: этот
со: со
убранство: убранство
высаживание: высаживание
менее: менее
важный: важно важен важное
помощь: помощью
тута: тут
вода: водой
а: а
правило: правилами
в: в
основной: основные
гравий: гравий
ступень: ступеней
и: и
живой: живых живой
ознакомиться: ознакомьтесь
растительность: растительности растительностью
можно: можно
основное: основное
подходить: подходят подходит
оттенять: оттенять
альтернативный: альтернативное
с: с
она: нее она
у: у
побеспокоить: побеспокоив
они: ними они
готовый: готовый
опасно: опасно
вариант: вариантом
мир: мир мира
больной: больных
цвет: цветов
структура: структура
вы: вы
оставить: оставьте
необходимый: необходимое
житель: жителями
обитатель: обитатели обитателей
этап: этап
необходимо: необходимо
абсолютно: абсолютно
слишком: слишком
корневой: корневой корневая
рыть: роющих
про: про
подробно: подробно
свое: своему
требование: требованиями требования
составлять: составлять
чтобы: чтобы
эстетический: эстетическую
также: также
появиться: появится
получение: получения
без: без
перед: перед
комплексный: комплексным
до: до
водоем: водоемам
полезный: полезных
помнить: помнить
особенность: особенности
обрамление: обрамлении
мелкий: мелким
адрес: адрес
рыба: рыб
биологический: биологической
ее: ее
субстрат: субстраты субстрата субстрат
подбирать: подбираем
образовывать: образовывать
фильтрация: фильтрации
слой: слой
период: период
грунт: грунт грунты грунта
проживать: проживают
предпочтительный: предпочтительнее
рекомендоваться: рекомендуется
система: система
застойный: застойные
рекомендовать: рекомендуем
отзыв: отзыв
же: же
дно: дно дна
один: одна
горный: горные
оценка: оценки
оттенок: оттенок оттенков
окрас: окрас
что: что
светлый: светлых
оценить: оцените
смотреться: смотрелись смотреться смотрятся
рыбка: рыбками рыбки рыбок
домашний: домашнего
ожидать: ожидают
неповторимый: неповторимой неповторимый
поверхность: поверхности поверхность
травник: травникам
высадок: высадка
зачем: зачем
залог: залог
некоторые: некоторые
изготавливаться: изготавливаются
зависеть: зависит
существовать: существуют
если: если
перезапуск: перезапуск
природный: природные природного природную
кусочек: кусочек
процесс: процесс
любой: любого
подвести: подведем
основа: основа основы
отличаться: отличается
растенье: растений
ничто: ничем
гармонировать: гармонируют
из: из
заменить: заменить
передержка: передержки
перерабатывать: перерабатывающие
удобрение: удобрением
естественный: естественный естественной
полтора: полутора
фундамент: фундамент
выигрышно: выигрышно
царство: царства
внутри: внутри
их: их
подложка: подложкой
преимущество: преимущество
заказ: заказ
специфический: специфические
замена: замена
жизненно: жизненно
карантинный: карантинные
грунтовый: грунтовый
грамотно: грамотно
фактически: фактически
тщательно: тщательно
различный: различные
особенно: особенно
смешивать: смешивайте
обращать: обращайте
галька: галька
должен: должна
разный: разных
подводной: подводного подводной подводных подводные
здоровый: здоровой
бывать: бывают
актуальный: актуальным
фракция: фракцией фракция фракций
гранула: гранул
фильтр: фильтр
собирать: собирая
нужно: нужно
строиться: строится
прекрасно: прекрасно
который: котором которой который
почва: почва почвы
вызывать: вызывает
это: это
большинство: большинству большинства
ли: ли
вкус: вкусу
рост: роста
речной: речная речной
вот: вот
кварцевый: кварцевый
запуск: запуска
привлекать: привлекает
жизнедеятельность: жизнедеятельности
создать: создать созданная
его: его
такой: таким такие такой такое
пустой: пустое
полноценный: полноценный
вместе: вместе
красивый: красивого
вод: воду
менять: менять
нужный: нужен
несколько: несколько
функция: функцию
разнообразие: разнообразие
активизация: активизации
или: или
решение: решение
водоросль: водорослей
грунтовой: грунтовых грунтовая грунтового
натуральный: натуральные натуральный
корень: корней
мы: мы
малек: мальков
крайне: крайне
функционировать: функционирующего
резервуар: резервуар резервуары резервуарах резервуара
на: на
состав: составу
водный: водного
считать: считают
не: не
использовать: использовать
выбор: выборе выбор
указать: укажите
содержать: содержат
хороший: лучше
аквариум: аквариум аквариума аквариумов
но: но
почта: почту
когда: когда
замкнутый: замкнутая
учитывать: учитывать учитывайте
длить: для
подводный: подводный
количество: количество
питательный: питательные питательного
цветовой: цветовую
начальный: начальных
составить: составит
нет: нет
развитие: развития
он: он
многогранный: многогранного
от: от
итог: итоги
планироваться: планируется
подчеркнуть: подчеркнет
пресноводный: пресноводными
искусственный: искусственные
дизайн: дизайн
поскольку: поскольку
внимание: внимание
все: всего
ваш: вашему вашего вашей ваш
представляться: представляется
по: по
укладка: укладкой укладки
ведь: ведь
развиваться: развивается
где: где
промыть: промойте
песок: песок
подготовить: подготовить
активный: активного активными
немой: нем
позволять: позволяет
очень: очень
способ: способ
толщина: толщина
товар: товар
какой: какими какой
наличие: наличии
продукт: продукты
подразумевать: подразумеваем
быть: будет будут был
яркий: яркие
переть: при
заранее: заранее
