состоять: состоит
приводить: приводит приводя
витамин: витамин
специальный: специальные специально специального специальным
раздражение: раздражение
новый: новый
поведение: поведения
патология: патологии
служить: служат
текстура: текстура
происходить: происходит
еще: еще
частично: частично
выйти: выйдут
заключаться: заключается
со: со
стирать: стирайте
пол: пола
помощь: помощь
а: а
в: в
зудеть: зудящей
заболевание: заболевания заболеваний
содержание: содержание содержанием
выводить: выводить
и: и
явление: явления
к: к
вплоть: вплоть
о: о
подходить: подходит
она: она ей ней
с: с
у: у
глотание: глотанию
подушечка: подушечки
течение: течение
лекарство: лекарство
регенерация: регенерации
десна: десна
они: они им них
пищевой: пищевые
оно: оно
уделять: уделяйте
обращаться: обращайтесь
клюква: клюквы
тонкий: тонкий
визит: визите визиты
кормить: кормить
слишком: слишком
небольшой: небольшого
время: время
называть: называют
цикорий: цикорий
глотать: глотают глотать
очищение: очищению
про: про
аналог: аналог
главный: главная
проблема: проблемы
также: также
корма: корма корм
чистоплотный: чистоплотных чистоплотные
появиться: появится
получение: получения
чихание: чихание
понравиться: понравится
следовать: следуйте
легко: легко
котик: котик
трава: траву траве трава травы
сначала: сначала
ослаблять: ослабляют
застревание: застревания
горох: гороха
начать: начать начнет
симптом: симптомам симптомы
почесать: почешите
отучить: отучить
овес: овса
переживать: переживать
заняться: заняться
массировать: массирует
почка: почек
себя: себя собой
короткошерстный: короткошерстных
рекомендоваться: рекомендуется
далекий: дальше
скапливаться: скапливается скапливаться скапливаются
случайно: случайно
рекомендовать: рекомендуем
отзыв: отзыв
витаминный: витаминная
купить: купите
один: одними один
нормальный: нормальное
оценка: оценки
иметь: имейте
совет: советов
индейка: индейкой
увлажнение: увлажнение
выявить: выявить
оценить: оцените
часть: часть
последний: последнее
волокно: волокна
формирование: формирования
некоторые: некоторых некоторые
помочь: помогут
частый: частые
укус: укусов
привлекательный: привлекательной
кислотно-щелочной: кислотно-щелочной
скопление: скопление
комбинация: комбинацию
процесс: процессе процесса процесс
нерастворимый: нерастворимую нерастворимые
минимизировать: минимизируют
злоупотреблять: злоупотребляйте
кожа: кожи
волосяной: волосяных
делать: делать делают делайте
уборка: уборку
курица: курицы
продвижение: продвижения
белка: белка
остаться: остались
скопиться: скопилось
клетчатка: клетчатку клетчатка
кишечник: кишечника
сезонный: сезонных
предотвращать: предотвращают
крыться: кроется
похожий: похожие
качество: качестве
через: через
косметический: косметическими
взрослый: взрослых
подойти: подойти подойдет
зерно: зерна
становиться: становится
результат: результате
влиять: влияет
особенно: особенно
большой: большое
бывать: бывает
животное: животных животное
из-за: из-за
временить: времени
увеличивать: увеличивают
чрезмерный: чрезмерное
облегчать: облегчает
рвотное: рвотными
нужно: нужно
обладать: обладает
интерес: интереса
солодовый: солодовый
вызывать: вызывают вызывая
это: это этом этого этим этому
обработка: обработки
поедание: поеданию
поддерживать: поддерживают поддерживает поддерживать
ткань: ткань ткани
вкус: вкусом вкусами
еда: еде
два: два
разобраться: разобраться
образовать: образуя
вполне: вполне
начинаться: начинается
кот: кот кота
стоить: стоит
его: его
улучшать: улучшают
сухость: сухость
жизнь: жизни
только: только
остальное: остальное
ветеринар: ветеринара
функция: функции
заражение: заражение заражения
линька: линьки
хорек: хорьков
или: или
отличие: отличие
относиться: относятся
допустить: допустить
чаща: чаще
точно: точно
смягчение: смягчения
уход: уход уходе
почему: почему
быстрый: быстрого
хороший: лучше хорошем
много: много более
когда: когда
профилактика: профилактике профилактики профилактика
значит: значит
страдать: страдающим
болезный: болезней
обычный: обычных
контейнер: контейнер
действие: действие действия
говядина: говядиной
разрешить: разрешено
первый: первой
желание: желание
состояние: состояние
идти: идти
увлажнитель: увлажнитель
тогда: тогда
мягкий: мягкого
стимулировать: стимулирует стимулируют
наблюдаться: наблюдаются
путем: путем
тканый: тканей
ваш: вашей ваш
так: так
старший: старше
там: там
иногда: иногда
ведь: ведь
понятный: понятной
больший: больше
мыть: мыть мойте
кто: кого
проглатывать: проглатывать
выделение: выделения
ион: ионы
активный: активными
считаться: считаются
использование: использованием
неделя: недели
всеять: всей
самый: самых самая самым
аномальный: аномальными
товар: товар
быть: быть
багровый: багровые
шерсть: шерсть шерстью
волосок: волоски
тоже: тоже
солод: солод
несъедобный: несъедобные
темный: темные
есть: едят есть ест
нежно: нежно
разработать: разработан
лишний: лишний
задуматься: задуматься
провоцировать: провоцировать
мочь: может могут
попадать: попадают
месяц: месяц
набрать: наберет
этот: эти эта этой
пищеварительный: пищеварительному пищеварительного
сам: саму сама самой
первичный: первичные
друг: друг друга
застрять: застрять
перистальтика: перистальтику
отлично: отлично
тута: тут
основной: основной
благотворный: благотворно
кошка: кошки кошка кошку кошек кошке
можно: можно
воздух: воздуха
отнести: отнести
дать: дадут
действовать: действовать
грубый: грубой
носоглотка: носоглотку
комочек: комочков комочками комочки
во: во
аппетит: аппетит
отдел: отдел
уже: уже
раз: раза раз
вы: вам
оставить: оставьте
образование: образования образование
проводить: проводить
цель: целях
просто: просто
регулярный: регулярные
простой: простым
скорость: скорость
свой: своей свою
экстракт: экстракт
тем: тем
чтобы: чтобы
рацион: рационов
противопаразитарный: противопаразитарные
проведение: проведения
толкнуть: толкнула
перед: перед
шерстить: шерсти
дома: дома
до: до
бесполезный: бесполезна
излишний: излишняя
увеличить: увеличьте
положить: положите
рвать: рвет
адрес: адрес
другой: других
работа: работе работу
весить: весь
интересно: интересно
вынудить: вынужден
давать: давать даваемой давайте
оставаться: оставаться
магний: магния
вовремя: вовремя
ее: ее
вылечить: вылечить
регулярно: регулярно
схожий: схожи
сухой: сухая сухой
посол: после
дезинфицирование: дезинфицирования
питание: питанием
профилактический: профилактических
период: период
микрофлора: микрофлоры
вычесывать: вычесывайте
число: числе
усиливать: усиливают
задерживаться: задерживаются
причина: причин причина причинами
комок: комками комок комков
накопиться: накопившиеся
достать: достать
вид: видов
же: же
сбалансированный: сбалансированный
попасть: попасть
купать: купайте
умывание: умывания
что: что чему чем
длительный: длительного
за: за
тип: типу
домашние: домашних
паразит: паразитов
указывать: указывает указывают
котенок: котятам
ожидать: ожидают
лакомство: лакомства лакомство
толкать: толкает
статья: статье
если: если
справляться: справляется
существовать: существуют
соответственно: соответственно
принцип: принципы
повод: повод
организм: организме организм
из: из
естественный: естественным естественный
бумага: бумаге
серьезный: серьезным
противовоспалительный: противовоспалительное
обволакивать: обволакивают
кусать: кусать
их: их
укреплять: укрепляют укрепляет
очищать: очищает
компонент: компоненты
язык: языка языке
всход: всходы
заказ: заказ
минимизация: минимизации
длинношерстный: длинношерстные длинношерстных
беспокоиться: беспокоиться
следить: следите
посещать: посещайте
оказывать: оказывает
мочекаменный: мочекаменной
заметить: заметили
здоровье: здоровью здоровье
смешивать: смешивая
влажный: влажным
нормализовать: нормализуют
право: праву
испытывать: испытывает
белый: белую
разный: разные разных
здоровый: здоровой
проглотить: проглотить
жирный: жирные
стенка: стенок стенки
год: лет
распространить: распространенное
лосось: лосося
обратиться: обратитесь
кишечный: кишечной кишечный
потеря: потеря
который: которые которую котором который которая
постоянный: постоянное постоянная
ухаживать: ухаживать
вывод: выводом вывода выводу выводы
поэтому: поэтому
избавиться: избавиться
выведение: выведения
заставлять: заставляет заставляют
подорожник: подорожника
чистота: чистотой
кусание: кусания
серебро: серебра
следующий: следующим
семя: семя семена
вредно: вредно
спуститься: спустился
привести: привести
пища: пища
вещь: вещи
вылизывание: вылизывании вылизывания
вот: вот
закупорка: закупорки
пропустить: пропустить
случай: случае случаях
сразу: сразу
оттуда: оттуда
такой: такого такое такие таких
плюс: плюс
овсяный: овсяные
вместе: вместе
паста: пасты паста
правильный: правильную
несколько: несколько
питомец: питомца питомцам питомец питомцу
решение: решения решении
строение: строении
проходить: проходя проходит
натуральный: натуральные
широкий: широкого
раздражать: раздражает
включать: включая
просвет: просвета
мы: мы
пик: пике
перечислить: перечисленными перечислим
на: на
попытка: попытках
состав: составе
тот: том то той тех
комплекс: комплекс
не: не
использовать: использовать
самостоятельно: самостоятельно
сложно: сложно
указать: укажите
частить: части
содержать: содержит содержат
миска: миски
но: но
почта: почту
боль: боли
баланс: баланс
вызвать: вызвано
идеальный: идеален
длить: для
фосфор: фосфора
начинать: начинает начинать
количество: количество количества
содержаться: содержится
уровень: уровне
чесать: чесать
обратить: обратить
понадобиться: понадобится
он: он
развитие: развитие
от: от
растворимый: растворимую
желудок: желудка
проветривание: проветривание
способствовать: способствует способствуют
мочевой: мочевого
блоха: блохи
как: как
внимание: внимание
все: все всего всех
низкий: ниже
глист: глисты
помогать: помогают помогает
проглатывание: проглатывании проглатывание
по: по
плохой: плохой
кислота: кислоты
юкка: юкка
посадить: посадите
опасный: опасных
риск: риск
порода: породы пород
улучшение: улучшения
выводиться: выводится выводятся
способ: способ
высокий: высокое
забывать: забывайте
наличие: наличие наличии
признак: признак признаками
проверить: проверьте
частица: частицы
проращивать: проращивать
переть: при
хрустеть: хрустящие
