болевой: болевым
приводить: приводит
терять: теряют
патология: патологии
поведение: поведение
есть: есть ест
панкреатит: панкреатит
охота: охота
ряд: ряду рядом
любить: любят
мочь: может могут
сытость: сытости
пищеварительный: пищеварительной
этот: этот
пить: пить
со: со
потомство: потомством
погода: погоду
апатичный: апатичному
друг: друга
неудачный: неудачное
интересовать: интересуют
а: а
вода: водой
в: в
подробный: подробнее
кошка: кошкой кошка кошки кошке кошку
отправляться: отправляйтесь
и: и
к: к
времяпрепровождение: времяпрепровождения
можно: можно
о: о
с: с
она: ней она
у: у
организовать: организовать
они: они
запас: запасов
аппетит: аппетит аппетита
домик: домиком
пищевой: пищевое
вес: веса
обращаться: обращаться
снижение: снижением
угощенье: угощений
искать: искать
базовый: базовые
раз: раз
вы: вы
оставить: оставьте
проводить: проводит
калория: калорий
кормить: кормите
специалист: специалист
время: время
недавно: недавно
проблема: проблемы проблем
тем: тем
составлять: составлять
вялость: вялости
чтобы: чтобы
также: также
корма: корм корма
чистоплотный: чистоплотные
появиться: появится
энергия: энергию
получение: получения
перед: перед
до: до
прием: приемов приема
котик: котика котику
увеличить: увеличено
нуждаться: нуждается
зависимость: зависимости
мясной: мясной
сначала: сначала
ежедневный: ежедневного
начаться: началась
адрес: адрес
другой: другой
вред: вред
родить: родила
переставать: перестает переставал
давать: давайте
вовремя: вовремя
накапливаться: накапливаются
ее: ее
дискомфорт: дискомфорт
отсутствие: отсутствием отсутствия
уменьшить: уменьшено
регулярно: регулярно
избыточный: избыточное
однако: однако
питание: питании
посол: после
принципиально: принципиально
период: период
причина: причин причиной причины
визуально: визуально
отказ: отказом
рекомендовать: рекомендуем
жаркий: жарко
отзыв: отзыв
незамедлительно: незамедлительно
кроме: кроме
голодать: голодает
поддержка: поддержке
оценка: оценки
всегда: всегда
обязательно: обязательно
что: что
за: за
оценить: оценит оцените
испачкать: испачкать
котенок: котята котят
лишь: лишь
ожидать: ожидают
брать: брать
лето: летом
свободный: свободное свободном
роды: родов
лакомство: лакомствами лакомства
если: если
существовать: существует
половой: половая
организм: организм организме
из: из
курица: курицу
наш: наш
обстановка: обстановки
ветеринарный: ветеринарную
белка: белкам
ранний: раньше
серьезный: серьезную
сопровождаться: сопровождаются
их: их
заказ: заказ
подозревать: подозреваем
замена: заменой
взрослый: взрослый
вдали: вдали
становиться: становятся
поступать: поступает
нравиться: нравится
грязный: грязной грязная
результат: результате
особенно: особенно
анализ: анализы
точный: точный
далее: далее
должен: должен должны
испытывать: испытывать
поставить: поставит
премиальный: премиального
верный: верный
являться: является являются
здоровый: здоровое
из-за: из-за
малыш: малышей
нужно: нужно
интерес: интерес
беременная: беременные
который: которая которые
вывод: выводы
краткий: краткие
порция: порции
это: это
пища: пище пищи
вкус: вкус
еда: еды еду
смена: смену
выбрать: выбрано
вот: вот
просить: просят
сразу: сразу
взять: возьмет
кот: кот
такой: таким такую такое
деть: день
полноценный: полноценной
малый: малый
только: только
жизнь: жизни
рассказывать: рассказываем
несколько: несколько
питомец: питомцу
баловать: баловать балуйте
место: место
или: или
проходить: проходите
возраст: возраста
мы: мы
чаща: чаще
на: на
свежий: свежей
переслать: перешли
не: не
указать: укажите
миска: миску миска
спокойный: спокойное
хороший: хорошее
но: но
маленький: меньше
почта: почту
испортить: испортить
отказываться: отказывается отказываться
привычный: привычной
когда: когда
появление: появление
длить: для
начинать: начинает
нарушение: нарушением
количество: количество количеством
волнительный: волнительный
нет: нет
список: список
он: он
жары: жары
поиск: поисках
состояние: состояние
от: от
норма: норма
переходить: переходит
мурлыка: мурлыка мурлыке
захватить: захваченная
голод: голод голода
поменять: поменять
перекармливать: перекармливаете
игра: игры
попробовать: попробуйте
как: как
размер: размера
сталкиваться: сталкивалась сталкиваясь
все: всего все
ваш: вашей ваш
отсутствовать: отсутствует
по: по
материнский: материнским
ставить: ставить ставьте
плохой: плохой
четвероногий: четвероногого
развиваться: развивается
больший: больше
огромный: огромное
постараться: постарайтесь
тихий: тихое
бытовой: бытовой
самый: самый
очень: очень
инстинкт: инстинктом
способ: способ
какой: какая
забывать: забывать
товар: товар
наличие: наличии
выбирать: выбирайте
быть: быть будут был
нестерилизованный: нестерилизованные
что-то: что-то
