долгий: долго дольше
витамин: витаминов витамином витаминами
специальный: специальный специальные специальная специальное специально
банк: банки
рыбный: рыбных
еще: еще ещё
учет: учетом
непременно: непременно
со: со
под: под
расстройство: расстройства
дополнительно: дополнительно
а: а
производство: производства
в: в
заболевание: заболевания
содержание: содержанием
и: и
макароны: макаронами
к: к
подходить: подходящего подходить подходящий подходит
о: о
с: с
она: ей
у: у
течение: течение
запах: запах
они: ними них они им
пищевой: пищевых пищевые пищевой пищевую
необходимый: необходимых необходимые
входить: входят
этап: этапе
кормить: кормящей
время: время
высокопитательный: высокопитательные
создавать: создавать создают
посоветоваться: посоветуйтесь
внутренний: внутренних
проблема: проблемой
легкоусвояемый: легкоусвояемыми
составлять: составляет составляют
заботиться: заботиться
также: также
корма: корма кормами корм
обитать: обитая
появиться: появится
получение: получения
недорогой: недорогими
употреблять: употреблять
вводить: вводить
греть: греют
отсутствие: отсутствие
какой-либо: каких-либо
требоваться: требуется требуются
аллергический: аллергические
почка: почек
зерновой: зерновых
рекомендоваться: рекомендуется рекомендуются
читать: читайте
рекомендовать: рекомендуем
отзыв: отзыв
приятный: приятные
соус: соус
один: один одна
оценка: оценки
консервный: консервные
обязательно: обязательно
иметь: имеют имейте
снизить: сниженным
физиологический: физиологическому
богатый: богаты
мякоть: мякоть
оценить: оцените
последний: последнем
класс: классов класс класса классы
часто: часто
высококачественный: высококачественные
лакомиться: лакомятся
некоторые: некоторые
предписание: предписанию
добавляться: добавляются
бренд: брендов бренды брендам
привлекательный: привлекательные
тереть: три
способный: способные
делать: делают
куриный: куриные
технология: технология
производить: производят производимые
белка: белки белка белками
положительно: положительно
подобный: подобными
среди: среди
первосортный: первосортные
качество: качество
через: через
отдельный: отдельных отдельные
влиять: влияющие
особенно: особенно
большой: большое
встречаться: встречается встречаются
должен: должен должны должна
животное: животных животные животного животными
единый: единая
наоборот: наоборот
временить: времени
насытить: насыщены
весомый: весом
различаться: различается
гармония: гармонию
нужно: нужно
возможно: возможно
питаться: питаться питаются питалась
это: этом это этого
разрезать: разрезает
сустав: суставов
сказаться: скажется
разница: разница
травяной: травяными
процент: процент
восстанавливаться: восстанавливаться
сертифицировать: сертифицированы
взять: взятые взяли
консультация: консультации
его: его
улучшать: улучшают
только: только
жизнь: жизни
покупать: покупать покупайте
ветеринар: ветеринаром ветеринара
переводиться: переводится
нельзя: нельзя
или: или
возраст: возрасте возраста возрасту
относиться: относится относятся относиться
унифицированный: унифицированная
чаща: чаще
подозрение: подозрением
почему: почему
тщательность: тщательностью
особый: особая
хороший: лучше
много: более
добавить: добавлены
совестить: совести
предотвратить: предотвратило
когда: когда
вкусный: вкусные
профилактика: профилактики
значит: значит
учитывать: учитывайте
страдать: страдают страдающих
жир: жиры жирами
разделяться: разделяются
общий: общем
болезнь: болезнь болезни болезнями
продолжать: продолжать
разрешить: разрешены
масса: массу
состояние: состоянии состояния
происхождение: происхождения
искусственный: искусственные
ориентироваться: ориентируйтесь
сохранять: сохранять
лечебный: лечебные лечебного лечебными лечебных
ваш: вашего вашей ваш
так: так
иногда: иногда
присутствовать: присутствует
ведь: ведь
больший: больше большую
срок: сроки
спросить: спросите
пшеница: пшеницы
потребоваться: потребуется
позволять: позволяет
привыкнуть: привыкшие привыкли
реакция: реакциями
всеять: всей
добавка: добавки
товар: товар
выбирать: выбирать
охотно: охотно
быть: были будет будут быть
трапеза: трапеза
исключение: исключение
есть: есть
внимательно: внимательно
роль: роли
разработать: разработаны разработанные
провоцировать: провоцировать
злаковый: злаковых злаковые
мочь: могут можете
этот: этой этими эти этот этих эта
сам: само самого
классификация: классификация
субпродукт: субпродуктов
тута: тут
авва: авва
бы: бы
давление: давлением
минерал: минералов
дать: дайте
соевый: соевого
использоваться: используются
производитель: производителей
отправлять: отправляют
вес: весу
уже: уже
хранение: хранения
вы: вы
оставить: оставьте
образование: образование
необходимо: необходимо
сердечно-сосудистый: сердечно-сосудистые
условно: условно
снижать: снижает
обстоять: обстоит
лечить: лечат
щенок: щенков
свой: своей свой
ветврач: ветврачом
популярный: популярны
чтобы: чтобы
рацион: рационы рационов рационах рационами
дикий: дикой
без: без
шерстить: шерсти
между: между
до: до
нуждаться: нуждаются
мясной: мясных
особенность: особенностей особенности
положить: положенного
выступать: выступают
потом: потом
расфасовывать: расфасовывают
адрес: адрес
другой: другой
работа: работу
давать: давать давайте
оставаться: остается
ее: ее
пожилой: пожилому
проконсультироваться: проконсультируйтесь проконсультироваться
избыточный: избыточным
иначе: иначе
сухой: сухие
посол: после
питание: питание
период: период
число: число
производиться: производятся
же: же
недостаточно: недостаточно
подход: подход
ингредиент: ингредиентов ингредиенты ингредиентам
сбалансированный: сбалансированные
что: чем что
недоставать: недостает недоставать
греческий: греческого
домашние: домашних
ожидать: ожидают
разделить: разделены
намного: намного
растительный: растительного
применяться: применяется
существовать: существует
если: если
консервированный: консервированные
повод: поводу
отличаться: отличаются
организм: организма организму
из: из
сахарный: сахарный
бездомный: бездомными
наш: наша
естественный: естественными
их: их
мясо: мясо мяса
получить: полученные
компонент: компонентов
заказ: заказ
покупка: покупке
омег: омега
различный: различных различные
мочекаменный: мочекаменной
здоровье: здоровья здоровье
диета: диета
влажный: влажные
прочий: прочих
разный: разного
белков: белков
будущее: будущем
распространить: распространенные
жидкость: жидкости
собака: собаки собак собаке собака
биохимический: биохимическими
беременная: беременной
человеческий: человеческой
который: который которых которые которое
вывод: выводы
поэтому: поэтому
хронический: хронические хронических
крупный: крупных
прогонять: прогоняют
диетический: диетические
следующий: следующим следующих следующие
подобрать: подобраны
пища: пищу
выбрать: выбрать выбрали
рассказать: расскажем
подбора: подбора
вот: вот
вместо: вместо
повышенный: повышенным
случай: случаи случае случаях
такой: такой такая таким таких такое
спровоцировать: спровоцировать
плюс: плюсы
деть: дело
строгий: строго
стабилизировать: стабилизированы
питомец: питомца питомцы питомцу
вкусовой: вкусовую вкусовые
протеин: протеина
овощ: овощей
включать: включая
мы: мы
на: на
состав: состав составе
подсказывать: подсказывает
тот: то те тех тот
комплекс: комплекс
выбор: выбора выбору выборе выбор
не: не
использовать: используют
каждый: каждый
указать: укажите
содержать: содержащим содержащие
но: но
стерилизовать: стерилизуют
почта: почту
щадить: щадящей
баланс: балансу
длить: для
количество: количество количеством
краситель: красителей красители
содержаться: содержатся
питательный: питательных
об: об
заменять: заменяют
понадобиться: понадобится
нет: нет
корм: кормов
название: название
развитие: развития
он: он ему
от: от
растворимый: растворимой
переходить: переходить
усвояемость: усвояемость
умеренный: умеренной
как: как
первое: первое
сталкиваться: сталкиваются
все: все всех всего
низкий: низкий
условие: условия
помогать: помогают
по: по
отсутствовать: отсутствуют
думать: думайте
склонный: склонны
соотношение: соотношение
немой: нем
постоянно: постоянно
риск: риск
порода: породы пород
способ: способ
высокий: высокого
какой: какой
забывать: забывайте
наличие: наличие наличии
достигать: достигает
пониженный: пониженным
источник: источники
переть: при
