запрыгивать: запрыгивая
специальный: специальными
личный: личный
частота: частота
раздражение: раздражение
дозировка: дозировке
таблетка: таблетки
прогулка: прогулкой
попросить: попросили
лапа: лапы
мочь: могут может
попадать: попадая
месяц: месяцев месяц
четыре: четыре
приложение: приложении
важный: важна
погода: погоду
выделять: выделяем
а: а
в: в
заболевание: заболеваний заболевания
гельминт: гельминтов гельминты
и: и
ознакомиться: ознакомиться
к: к
применение: применением
можно: можно
илья: илью
подходить: подходящее
о: о
домыть: домой
с: с
переносчик: переносчиков переносчиками
средство: средствам средство средства средствами
шампунь: шампуни
сезон: сезон сезону
клещ: клещей клещи
они: они
наступление: наступлением
вес: вес
уже: уже
дата: дату
извинить: извините
раз: раз
вы: вам вы вами
оставить: оставьте
смертельный: смертельной
необходимо: необходимо
обитание: обитания
регулярный: регулярная
тест: тест
внутренний: внутренним внутренних
выходить: выходите
тем: тем
составлять: составлять
также: также
обитать: обитать
появиться: появится
получение: получения
без: без
гарантировать: гарантируют
перед: перед
сайт: сайте
до: до
прием: приема
напомнить: напомним
написать: напишем
трава: траве
диагностироваться: диагностируется
страшный: страшных
находиться: находится
адрес: адрес
вред: вред
вовремя: вовремя
устанавливаться: устанавливается
дискомфорт: дискомфорт
период: период
система: системы
приближаться: приближается
тяжелый: тяжело
рекомендовать: рекомендуем
отзыв: отзыв
вид: виды
постепенно: постепенно
один: одними
оценка: оценки
оба: обе
гельминтоз: гельминтозы
что: что
оценить: оцените
домашние: домашним домашние
паразит: паразиты паразита паразитов
часть: часть
лишь: лишь
эктопаразит: эктопаразитам
последний: последнего
ожидать: ожидают
одинаково: одинаково
дорогой: дорого
инструкция: инструкцией инструкции
лето: летом
помочь: поможет
зависеть: зависит
инкубационный: инкубационный
если: если
обновлять: обновлять
обувь: обувь
плюсовой: плюсовой плюсовая
протекать: протекает
размножаться: размножаться
традиционно: традиционно
подъезд: подъездах
из: из
кожа: кожи
среда: среду
детальный: детальная
наш: наш
ветеринарный: ветеринарного
их: их
через: через
заказ: заказ
пудра: пудры
покупка: покупке
врач: врача
различный: различные
мобильный: мобильном
анаплазмоз: анаплазмоз
опасность: опасности
являться: являются
бывать: бывают
заразить: зараженное
проводиться: проводится
год: год
животное: животным животному животное
защитить: защитить
михайлов: михайлова
круглый: круглый
нужно: нужно
поэтому: поэтому
например: например
вызывать: вызывают
любимец: любимец
группа: группы
следующий: следующей
переносить: переносят
обработка: обработка обработки обработку обработке
это: это
гулять: гуляющие
пища: пище
ошейник: ошейники
выбрать: выбрать выбранного
рассказать: рассказать
начинаться: начинается
температура: температуры температура
эндопаразит: эндопаразитам
жить: жить
малый: малый
вод: воде
капля: капли
питомец: питомцев питомцы питомца питомцу питомцем питомце
улица: улице улицу
регион: регионах
или: или
беззащитный: беззащитны
возраст: возраст
живете: живете
относиться: относятся
мы: мы
слизистая: слизистых
на: на
необработанный: необработанной
теплый: теплых
защита: защиты защиту защита
не: не
почему: почему
каждый: каждой
указать: указана укажите
хороший: лучшая
много: более
но: но
наносить: наносим
почта: почту
добавить: добавьте
когда: когда
слабеть: слабеет
внешний: внешним
учитывать: учитывайте
длить: для
догадываться: догадываются
обрабатывать: обрабатывать
начинать: начинать
привязать: привязаны
личинка: личинок
холодный: холодную
действие: действия
орган: органов
ночь: ночью
список: список
кабинет: кабинет
от: от
февраль: феврале февраля
подвал: подвалах
блоха: блохи блох
причинять: причиняют
как: как
препарат: препарата
глист: глисты
марта: марте марта
ваш: вашу вашему вашей ваш
именно: именно
главное: главного
бессимптомный: бессимптомно
срок: срока сроке
вентиляция: вентиляции
информация: информация информацию
активный: активны
опасный: опасны
одежда: одежду
неделя: недель
способ: способ
какой: какой какие какое
товар: товар
наличие: наличии
переть: при
