долгий: дольше
налет: налет
специальный: специальные
таблетка: таблетки таблеток
образ: образом
есть: есть
пахнуть: пахнет
установить: установить
ряд: ряд
население: населения
воды: воды
борьба: борьбе
вероятно: вероятно
юридический: юридический
помощь: помощью
стекло: стеклам
тута: тут
в: в
аквариумист: аквариумисты аквариумистам
реклама: реклама
содержание: содержанием
и: и
можно: можно
рекламодатель: рекламодатель
съедаться: съедался
с: с
сочетать: сочетают
камень: камням камнями
позволить: позволят
запах: запахи
они: ими они них
пищевой: пищевых
уже: уже
извинить: извините
бросать: бросать
раз: раза
остаток: остатки
вы: вы
оставить: оставьте
необходимый: необходимы
обитатель: обитателями
кормить: кормить кормите
обойтись: обойтись
быстро: быстро
загрязнение: загрязнение загрязнением
спать: спать
органик: органики
ооо: ооо
кормление: кормления
разложение: разложение
сильный: сильным
проблема: проблем проблемы
популярный: популярные
предпочтенье: предпочтений
сомовый: сомов
чтобы: чтобы
также: также
корма: корма корм
чистый: чистой
дневной: дневные
появиться: появится
получение: получения
перенаселение: перенаселение
правильно: правильно
час: час
между: между
до: до
написать: напишем
заводить: заводят
сосед: соседи
адрес: адрес
другой: другими другие других
рыба: рыб рыбы
света: света
креветка: креветками
перекорм: перекорм
оставаться: остается
ее: ее
доставаться: достается
инна: инн
отрегулировать: отрегулируйте
дополнить: дополнить
слой: слоев
однако: однако
последствие: последствиями
посол: после
растительноядный: растительноядных
грунт: грунте грунта
гагарин: гагарина
офис: офис
голодный: голодными
причина: причину
темнота: темноте
рекомендовать: рекомендуем
отзыв: отзыв
вид: вида
съедать: съедают
дно: дно
внести: внести внесите
оценка: оценки
иметь: иметь имеет
совет: советов
что: что
за: за
оценить: оцените
рыбка: рыбки рыбок
лишь: лишь
практический: практически
ожидать: ожидают
московский: московская
минута: минуты
растительный: растительных
часто: часто
верхний: верхних
заросль: заросли
некоторые: некоторые
зависеть: зависеть
выключение: выключения
помочь: помогут
сомик: сомики сомиков сомикам
если: если
всеядный: всеядными всеядных
добраться: доберутся
обл: обл
любой: любой
желательно: желательно
растенье: растений
копошиться: копошатся
из: из
плотность: плотность
делать: делать
остаться: остаться
их: их
неприятно: неприятно
компонент: компонентов
доедать: доедая
через: через
заказ: заказ
водорослевый: водорослевый
сделать: сделайте
серия: серия
бывать: бывают
фильтр: фильтра
ускорить: ускорит
ползать: ползают
стараться: старайтесь
нашествие: нашествием
нужно: нужно
который: которые который
опускаться: опускаются
избавиться: избавиться
убрать: уберет
например: например
это: это
большинство: большинство
еда: еды
два: два
вот: вот
пропустить: пропустили
ночное: ночные
мутнеть: мутнеет
находить: находя
такой: таких таким
справиться: справиться
деть: день
неприятный: неприятные
покупать: покупая
вод: вода
несколько: нескольких
подмена: подмену
место: место
или: или
решение: решения
водоросль: водоросли водорослями водорослей
подъедать: подъедают
мы: мы
на: на
травоядный: травоядными
тот: то
не: не
использовать: используйте
выбор: выбор
каждый: каждую
донный: донные донных
указать: укажите
декорация: декорации
аквариум: аквариум аквариума аквариуме
но: но
много: более
маленький: меньше
поедаться: поедаются
почта: почту
когда: когда
профилактика: профилактика
длить: для
сома: сомам
начинать: начинающие
обратить: обратите
вьюнов: вьюновых
нет: нет
смешанный: смешанного
лист: листьям
даже: даже
от: от
санитар: санитары
вопрос: вопросом
тогда: тогда
как: как
сталкиваться: сталкиваются
внимание: внимание
все: все
препарат: препараты препарат
именно: именно
ваш: вашим вашей ваш
помогать: помогают
устранить: устранить
так: так
по: по
где: где
активный: активные
жуковский: жуковский
дальнейший: дальнейшем
постоянно: постоянно
столкнуться: столкнулись
соскабливать: соскабливая
неделя: неделю
способ: способ
высокий: высоким
забывать: забывайте
товар: товар
наличие: наличии
сородич: сородичи
быть: будет будут
пластинка: пластинки
активно: активно
