нитрат: нитратов нитраты
формула: формулой
день: дни
расположение: расположением
найти: найти
учет: учетом
мочь: можете может
воды: воды
объем: объем объемов объемах
менее: менее
важный: важный важно
неудачный: неудачным
вырастить: вырастить
протяжение: протяжении
юридический: юридический
а: а
в: в
основной: основной
усиливаться: усиливается
концентрация: концентрация
реклама: реклама
содержание: содержания
и: и
стресс: стресса стресс
можно: можно
рекламодатель: рекламодатель
о: о
шумный: шумном
вероятность: вероятностью
с: с
позволить: позволят
они: они
замедляться: замедляться
удивительный: удивительный
уже: уже
разгрузочный: разгрузочные
извинить: извините
обеспечить: обеспечить
весь: всю
раз: раза раз
очередь: очередь
того: того
вы: вы вам
оставить: оставьте
необходимый: необходимого
обитатель: обитателей
необходимо: необходимо
кормить: кормить
небольшой: небольших
регулярный: регулярных
снижать: снижать
еженедельный: еженедельных
ооо: ооо
скорость: скорости
кормление: кормление
свой: свою
тем: тем
чтобы: чтобы
также: также
корма: кормами корма корм
чистый: чистая
появиться: появится
получение: получения
основополагающий: основополагающий
написать: напишем
снова: снова
останавливаться: останавливаться
степень: степенью степень
адрес: адрес
рыба: рыбы рыба рыбу рыб
соответствие: соответствии
начать: начнет
однажды: однажды
давать: дают
отсутствие: отсутствие
инна: инн
регулярно: регулярно
однако: однако
посол: после
гагарин: гагарина
офис: офис
число: числа
факт: факт
рекомендовать: рекомендуем
отзыв: отзыв
вид: вида видов
потребность: потребностей потребностями
же: же
кроме: кроме
недостаточно: недостаточно
один: одного
оценка: оценки
иметь: иметь
что: что чем
контролировать: контролировать
оценить: оцените
рыбка: рыбок рыбка
лишь: лишь
последний: последний
ожидать: ожидают
московский: московская
максимальный: максимальный
высококачественный: высококачественными
зависеть: зависит
если: если
тереть: три
обл: обл
любой: любых
отличаться: отличаться
избыток: избытка
из: из
говорить: говорили
возрастной: возрастных
негативный: негативно
естественный: естественным
перенаселять: перенаселять
заказ: заказ
повышение: повышения
взрослый: взрослым
фактор: фактор факторов
заметить: заметить
здоровье: здоровье
большой: большой большого
должен: должен
разный: разных
питательность: питательность
здоровый: здоровыми
распространить: распространенное
увеличение: увеличение
временить: времени
стараться: старайтесь
нужно: нужно
безопасность: безопасность
который: который которые
поэтому: поэтому
выведение: выведения
чистота: чистота чистоту
стремительно: стремительно
крупный: крупными
например: например
вызывать: вызывать
неподходящий: неподходящими
это: это
ограничивать: ограничивает ограничивают
затянуться: затянувшаяся
подобрать: подобранный
рост: рост роста
сказываться: сказываются
два: два двух
молодая: молодым
замедлять: замедляют
его: его
такой: таких
деть: дело день
жизнь: жизнь
конкурент: конкурентов
вод: воде вода
нужный: нужны
отчасти: отчасти
подмена: подменах подмены подмен
место: месте
оптимальный: оптимальные
или: или
возраст: возраста
мы: мы
чаща: чаще
на: на
тот: то том
не: не
использовать: используйте
указать: укажите
расти: растут растет расти
хороший: хорошие
аквариум: аквариума аквариуме аквариум
маленький: меньше
почта: почту
относительно: относительно
вызвать: вызвать вызван
когда: когда
длить: для
категория: категорий
количество: количество
питательный: питательный
останавливать: останавливают
уровень: уровня уровень
влияние: влияние
общий: общем
понадобиться: понадобятся
чего: чего
худой: хуже
первый: первый
даже: даже
от: от
усвояемость: усвояемости
перекармливать: перекармливать
путем: путем
помять: помните
размер: размер
все: всего
низкий: ниже
условие: условиях условиями условия
помогать: помогает помогают
ваш: вашей ваш
мнение: мнение
правда: правда
активный: активного
жуковский: жуковский
попадание: попадания
оборудование: оборудования
очень: очень
способ: способ
высокий: высокую
забывать: забывайте
линейка: линейке
товар: товар
наличие: наличии наличием
выбирать: выбирать
быть: будет быть
яркий: яркими
второй: второй
переть: при
