выплескивать: выплескивать
специальный: специальной специальный
банк: банки
лед: льда
нагрузка: нагрузки
есть: есть
найти: найти
темнеть: темнеет
прогулка: прогулку прогулкам прогулки прогулка прогулками прогулок прогулках прогулке
еще: еще
простудиться: простудиться
таять: тает
любить: любят
физический: физические физической
помешать: помешать
мочь: могут может
лапа: лап
успех: успехи
со: со
менее: менее
погода: погоду
под: под
проверять: проверяйте
плохо: плохо
а: а
вода: водой
вообще: вообще
в: в
основной: основные
смыть: смойте
содержание: содержание
выводить: выводить
и: и
к: к
можно: можно
о: о
продолжаться: продолжаться
корка: корка
с: с
ограничиться: ограничиться
возможный: возможны
снег: снегом снег снегу
шампунь: шампунями
элемент: элементами
они: им они
во: во
наступать: наступает
ветер: ветры
отпускать: отпускаете
вернуться: вернуться
извинить: извините
сугроб: сугробах
успеть: успел
вы: вы вам
оставить: оставьте
необходимый: необходимы
разбить: разбитые
выпадать: выпадает
бояться: боитесь
необходимо: необходимо
светать: светает
быстро: быстро
время: время
россия: россии
забыть: забудьте
про: про
смотреть: смотрите
бутылка: бутылки
рано: рано
выходить: выходить
свой: свою
нужда: нужды нужду
очистить: очистить
сильный: сильные сильно сильный
свое: своими своих своего
обморожение: обморожение обморожения
чтобы: чтобы
да: да
появиться: появится
энергия: энергию
получение: получения
необходимость: необходимость
понравиться: понравятся
дома: дома
час: часа
легко: легко
комбинезон: комбинезон
написать: напишем
полярный: полярный
образовываться: образовываться
декоративный: декоративные
надевать: надевайте
снова: снова
особенность: особенности
страшный: страшен
северный: северных
потом: потом
мелкий: мелких
мазь: мазью
адрес: адрес
справить: справить
вынудить: вынуждены
воск: воском
мороз: мороз морозы
ботинок: ботинки
заняться: заняться
ее: ее
песик: песик
перемещение: перемещениями
мячик: мячики
посол: после
выгуливать: выгуливать
сколько: сколько
короткий: короткими
темнота: темнота темноты
отзыв: отзыв
посоветовать: посоветуем
разбросать: разбросано
купить: купите
оценка: оценки
одевать: одевайте
консервный: консервные
везде: везде
метель: метель
что: что
стильный: стильные
за: за
пользоваться: пользуйтесь
оценить: оцените
поскользнуться: поскользнуться
урон: урон
грязь: грязь
поощрять: поощряйте
отравиться: отравиться
последний: последнее
ожидать: ожидают
минута: минут минутами
активность: активности
дорогой: дороги
некоторые: некоторых некоторые
лакомство: лакомствами
получаться: получается
статья: статье
если: если
обувь: обуви
прыгнуть: прыгнуть
захотеть: захочет
потерять: потерять потеряете
минимизировать: минимизировать
способный: способны
подстерегать: подстерегают
делать: делать
наш: нашей
грязно: грязно
ходить: ходите
естественный: естественной
переохлаждение: переохлаждение
обработать: обработайте
их: их
кольцо: кольца
заказ: заказ
зимой: зимой
воспользоваться: воспользоваться воспользуйтесь
игрушка: игрушки
оказаться: оказаться
приучить: приучить
длинношерстный: длинношерстных
следить: следите
перепад: перепадах
тщательно: тщательно
большой: велик
нанести: нанести
должен: должна
довольный: довольно
опасность: опасности
посыпать: посыпают
конечно: конечно
курточка: курточка
пес: пес пса
поздно: поздно
наоборот: наоборот
собака: собаку собаки собак собакой собакам собаке
поводок: поводка
достаточно: достаточно
нужно: нужно
который: которым которые
поэтому: поэтому
легкий: легче
уследить: уследить
переносить: переносит
это: этом это этого
вкус: вкус
ошейник: ошейник
рассказать: расскажем
страна: стране
вполне: вполне
светящийся: светящийся светящимися
инструмент: инструменты
температура: температурам температур
такой: такими такую таким
его: его
деть: день
мусор: мусор
покупать: покупайте
питомец: питомцами питомец питомца питомцев питомцем
улица: улицах
шапка: шапка
пеленка: пеленкой
регион: регионах
или: или
далеко: далеко
приспособить: приспособлены
мы: мы
стеклянный: стеклянные
перечислить: перечислим
сожаление: сожалению
действительно: действительно
на: на
теплый: теплый теплее
тот: том те то
не: не
ранка: ранок
использовать: используйте
образоваться: образуется
сложно: сложно
указать: укажите
хороший: лучше
много: много
тренировка: тренировкой
почта: почту
разрешать: разрешайте
когда: когда
реагент: реагентами реагенты
вкусный: вкусный
промывать: промывайте
появление: появления
длить: для
шарфик: шарфик
дождь: дождь
поваляться: поваляться
поиграть: поиграйте
он: он него
даже: даже
от: от
маячок: маячок
парка: парках
бегать: бегайте
холод: холод
игра: игры
попробовать: попробовать
как: как
лапка: лапки лапкам
все: все
низкий: низким
гололед: гололед
ваш: вашей ваш
так: так
лужа: лужи
ведь: ведь
больший: больше большие
мыть: мойте
кто: кто
песок: песком
риск: риск
одежда: одежду
очень: очень
порода: породы пород
нацепить: нацепите
способ: способ
забывать: забывайте
товар: товар
какой: какие
наличие: наличие наличии
уходить: уходить
аксессуар: аксессуары
выбирать: выбирайте
произойти: произошло
охотно: охотно
быть: быть будет
переть: при
