долгий: долго
поездка: поездкам
отличительный: отличительные
стандартный: стандартные
специальный: специально специальные специальный
покушаться: покушался
воспитать: воспитать
милиция: милиции
образ: образом
таблетка: таблетки
ухо: уши
промышленный: промышленных
служить: служат
еще: еще
прогулка: прогулок
любить: любят
физический: физическая физической
позаботиться: позаботьтесь позаботиться
обзор: обзор
эффективный: эффективны
воды: воды
со: со
менее: менее
важный: важными важно
доступ: доступе доступ
охранять: охраняя
под: под
фенотип: фенотипу
помощь: помощью
стабильный: стабильной
пол: пол
а: а
человек: человека людям
кормушка: кормушки
в: в
содержание: содержание
распространиться: распространилась
и: и
охотничий: охотничьих
качественный: качественную
к: к
о: о
подходить: подходящие подходящих
чужая: чужих
с: с
средство: средства
у: у
положительный: положительном
шампунь: шампунь
течение: течение
тягловый: тягловых
они: они них
сезон: сезон
земля: земле
выдержать: выдержать
вольер: вольер
конкретный: конкретного
возникновение: возникновением
теперь: теперь
необходимый: необходима необходим
римляна: римлянами
скот: скота
кормить: кормят кормящих кормить
автомобильный: автомобильные
небольшой: небольших
планировать: планируете
время: время
конец: концу
кормление: кормления
мощный: мощную
сильный: сильно сильных сильный
проблема: проблем
перевод: переводе
также: также
корма: корм
чистый: чистая чистой
член: членами членом
неприхотливый: неприхотливы
появиться: появится
получение: получения
оставлять: оставлять
носить: носить
поддержание: поддержания
подстригать: подстригать
следовать: следовать следует
час: часа
мебель: мебели
допускать: допуская
легко: легко
прием: приема
здоровяк: здоровяки здоровяк
распространяться: распространяться
прийтись: придется
зависимость: зависимости
возрождение: возрождению
охрана: охраны
построить: построенные
территория: территории
употреблять: употребляла
начаться: началось
вложить: вложить
посторонний: посторонним
чреватый: чревато
комфортно: комфортно
однажды: однажды
надо: надо
кинологический: кинологической
обеспечивать: обеспечивало
подбирать: подбирать
хотя: хотя
однако: однако
слой: слой
порядок: порядка
себя: себе
рекомендоваться: рекомендуется
случайно: случайно
полиция: полиции полиция
рекомендовать: рекомендуем
отзыв: отзыв
хвостатый: хвостатые
допускаться: допускается
один: одно одного
оценка: оценки
обязательно: обязательно
иметь: имеет
индейка: индейкой
мера: мере
оценить: оцените
активность: активность активности
некоторые: некоторые
подрасти: подросший
наскучить: наскучит
германский: германской
тереть: три
лежанка: лежанка
способный: способный
говорить: говорить
курица: курицей
делать: делать
римский: римские
развивать: развивают
похожий: похожие
качество: качестве
через: через
взрослый: взрослых взрослые взрослой
подойти: подойдет подойдут
наставник: наставника
приучить: приучите
становиться: становится
официально: официально
отдельный: отдельная
коготь: когтей когти
особенно: особенно
должен: должны должна должен должно
массивный: массивные
довольный: довольно
являться: являются
из-за: из-за
животное: животными
чистить: чистить
предок: предки
стать: стали стать
достаточно: достаточно
нужно: нужно
работать: работают работали
отличный: отличными
проявление: проявлению
сытый: сытый
приобретать: приобретайте приобретать
завозиться: завозиться
предрасположенный: предрасположены
должное: должным
переносить: переносят
травмировать: травмировали
умный: умные
это: это
прочный: прочных
обработка: обработку
поедание: поедания
рост: роста
еда: еду
два: два две
ошейник: ошейник ошейники
смена: смены
процент: процент
изучить: изучите
привлекать: привлекали
настроить: настроенную
стоить: стоит
интеллектуальный: интеллектуальные интеллектуальных
иметься: имеющейся
только: только
опрокинуть: опрокинуть
остальное: остальное
штутгарт: штутгарте
менять: менять
капля: капли
овчарка: овчаркой
средний: средние средним средних
улица: улице
или: или
питьевой: питьевая питьевую питьевой
возраст: возраста
допустить: допустить
вальяжный: вальяжны
защита: защиту защиты защите
переслать: перешли
минимум: минимум
заводчик: заводчики
протирать: протирать
уход: уходе уход
нарушитель: нарушителей
спокойный: спокойно спокойным спокойный
хороший: хорошего лучше
когда: когда
играть: играть
профилактика: профилактики
автопоилка: автопоилкой
оберегать: оберегать
действие: действия
говядина: говядиной
ссср: ссср
означать: означает
обрести: обрела
норма: нормы норм
приобрести: приобрести
германий: германии
мягкий: мягкая
игра: играм
высота: высоту
ваш: вашего ваше вашему вашей ваш
доминантный: доминантного
так: так
федерация: федерацией
четвероногий: четвероногими четвероногие четвероногого четвероногому
империя: империю
возникнуть: возникло
где: где
мыть: мыть
личность: личность
активный: активное активной активным
полость: полость
узкий: узкой
пора: пор
неделя: неделю
всеять: всей
крепыш: крепыши
обзавестись: обзавестись
товар: товар
выбирать: выбирать
быть: были была был будут быть будете
послужить: послужил
шерсть: шерстью шерсть
радостно: радостно
тоже: тоже
частота: частота
земеля: земель
достаточный: достаточное
плодородный: плодородные
есть: есть
грузить: груженные
внимательно: внимательно
расслабиться: расслабиться
давний: давних
лишний: лишнего
отечественный: отечественной
мочь: может можете могут
месяц: месяц
этот: эти этих эта этой
сам: самого
интеллект: интеллект
подкрепление: подкреплении
тревожить: тревожить
погода: погоду
уверить: уверенного
друг: друзья
плохо: плохо
знойный: знойный
стрижка: стрижки
амуниция: амуниция
сохранить: сохранит
основной: основная основных
палочка: палочки
гельминт: гельминтов
авва: авва
ознакомиться: ознакомившись
характер: характер
льняной: льняным
можно: можно
действовать: действуют
немецкий: немецкой немецкого
век: века
смочь: смог сможет
стандарт: стандарт
во: во
аппетит: аппетитом
готовый: готовые
интерактивный: интерактивные
признать: признала признана
завоевательный: завоевательных
специализация: специализации
раз: раза раз
вы: вам вы
оставить: оставьте
российский: российскую
освоение: освоение
проводить: проводить
необходимо: необходимо
соблюдать: соблюдать
регулярный: регулярной
охлаждать: охлаждающий
личной: личном
сутки: суток
толпа: толпу
щенок: щенкам щенки щенка
обычно: обычно
воспитание: воспитании воспитанием
свое: свои свое
тем: тем
чтобы: чтобы
назвать: назвать назвали
здесь: здесь
рацион: рационы рационов рационе рациона
торговый: торговые
без: без
перевозить: перевозили перевозить
до: до
великий: великой
полезный: полезна
нуждаться: нуждаются
представитель: представителей
заводить: заводить заводя
мясной: мясных
особенность: особенностями
сотрудник: сотрудник
ежедневный: ежедневных ежедневном
адрес: адрес
другой: других другими
завезти: завезены
ориентировать: ориентированы
клетка: клеткой
давать: давать
черта: черты
ее: ее
пожилой: пожилых
проконсультироваться: проконсультироваться
регулярно: регулярно
питание: питанием
посол: после
сухой: сухой
переедание: перееданию
период: период
вычесывать: вычесывать
лежак: лежаки
число: числе
клуб: клуб
охранный: охранный
повредить: повредить
ласковый: ласкова
жаркий: жаркий
вид: вида
войско: войска
усваиваться: усваиваются
выносливый: выносливые
попасть: попала
всегда: всегда
ягненок: ягненком
регулируемый: регулируемой
купать: купать
конвойный: конвойными
служебный: служебного служебной
выразить: выражен
скучать: скучал
грызть: грызть
что: что чем
масло: маслом
четкий: четко
длительный: длительных длительном
зуб: зубов
править: правил
за: за
тип: типа
домашние: домашними
гигиенический: гигиеническим
лосьон: лосьоны
численность: численность
паразит: паразитов
дом: дом
ожидать: ожидают
свободный: свободном
настоящее: настоящие
лакомство: лакомство лакомством
гамак: гамаки
зависеть: зависит
набор: набору
процедура: процедурам процедур
если: если
справляться: справляются
современный: современных современной современное
повод: поводом
смелый: смело
отличаться: отличаются
честь: честь
отношение: отношении отношения отношению
организм: организмом
из: из
ветеринарный: ветеринарным
ранний: ранняя раньше раннего
серьезный: серьезную серьезной
экстерьер: экстерьера
опека: опеке
их: их
соплеменник: соплеменниками
хвост: хвост
заказ: заказ
игрушка: игрушки игрушка
около: около
сделать: сделаны
социализация: социализация
дорожный: дорожных
служба: службой
здоровье: здоровья
заниматься: заниматься
транспортировка: транспортировки
влажный: влажный влажным
разный: разных
здоровый: здоровых
компаньон: компаньонами
год: года году
кг: кг
пес: псы псов пес
жидкость: жидкости
собака: собаки собак собака собаку собаке
стачиваться: стачиваться
международный: международной
ко: ко
поводок: поводок
слабовидящий: слабовидящим
наравне: наравне
необученный: необученные
беременная: беременных
безопасность: безопасности
который: которое котором которых который которые
постоянный: постоянной
ухаживать: ухаживать
поэтому: поэтому
декада: декаде
крупный: крупных крупной
любимец: любимцу
недоверчивый: недоверчивы недоверчиво
следующий: следующие
подобрать: подобрать подберите
пища: пищи
осанка: осанки
вещь: вещей
подбора: подборе
повышенный: повышенным
хорошо: хорошо
помощник: помощниками помощники
инструмент: инструменты инструмент
создать: создали
температура: температура
такой: такую такой такая
правильный: правильном правильной правильного
ночной: ночная
сопровождение: сопровождения
вод: воду
сыскать: сыскала
жировой: жировой
надежный: надежную надежных
несколько: несколько
питомец: питомцы питомца питомец питомцу
место: место
регион: регионе
успешный: успешно
проходить: проходили
собираться: собирались
натуральный: натуральный
включать: включающих
летний: летний
мы: мы
на: на
тот: том тех то
не: не
использовать: использовать используя используйте
преданный: преданными преданным
каждый: каждый
указать: укажите
содержать: содержать
миска: миски миской мисках
любитель: любителей
но: но
поедаться: поедаются
почта: почту
купировать: купировать
пищеварение: пищеварения
советовать: советуем
история: история
длить: для
количество: количество
уровень: уровнем
заключение: заключение
холодный: холодную
обратить: обратить
понадобиться: понадобится понадобятся
корм: кормов
название: название
развитие: развитие
он: он
семья: семье семьи
семью: семью
даже: даже
общаться: общаться общаются
от: от
желудок: желудок
молодой: молодом
придерживаться: придерживаться
блоха: блох
как: как
первое: первое
внимание: внимание
все: всем все
челюсть: челюстей
разогнать: разогнать
помогать: помогают
возможность: возможностью возможность
по: по
отсутствовать: отсутствуете
защитный: защитный
приучать: приучать
склонный: склонны
информация: информация
занять: заняли
бесконтрольный: бесконтрольного
выгул: выгула
очень: очень
порода: породы породу порода пород
выводиться: выводились
способ: способ
высокий: высокий
агрессия: агрессии
забывать: забывая
наличие: наличии
занятие: занятий
уходить: уходите
произойти: произошедший
проверить: проверенных
активно: активно
второй: второй
переть: при
