приводить: приводит
специальный: специальным
расположение: расположению
ухо: уха ушах уши ушей
происходить: происходит
бактерия: бактерий
поразить: пораженного
местный: местного
мочь: может могут
лапа: лапой
этот: этих
хирургический: хирургическое
ушной: ушного
под: под
полный: полной
плохо: плохо
тряска: тряска
отит: отит отита отиту отите
а: а
в: в
основной: основные
отмечаться: отмечаются
заболевание: заболевания
реклама: реклама
кошка: кошек
и: и
к: к
внезапно: внезапно
можно: можно
подходить: подходящий
наружный: наружный
осложняться: осложняется
с: с
исследование: исследованием
у: у
относить: относят
смысл: смысл
запах: запах
очевидный: очевидной
во: во
разделять: разделяют
оно: оно
утолщаться: утолщается
того: того
возникновение: возникновении
оставить: оставьте
распознать: распознать
царапание: царапание
клинический: клинического
время: время
оболочка: оболочка
создавать: создает
очищение: очищение
волос: волос
порочный: порочный
ооо: ооо
внутренний: внутреннего
обычно: обычно
разрыв: разрыву
свое: своего
раздеть: раздел
тем: тем
чтобы: чтобы
также: также
появиться: появится
наружное: наружного
получение: получения
до: до
распространяться: распространяется
диагностироваться: диагностируется
вторичный: вторичные
степень: степени
адрес: адрес
другой: других
чистка: чистка
соответствие: соответствии
требовать: требует
аллергический: аллергические
избыточный: избыточную
повышать: повышают
однако: однако
удалить: удалить
наклон: наклон
проживать: проживающих
инородный: инородное
анамнез: анамнеза
анатомический: анатомическому анатомические
причина: причины причин причина
рекомендовать: рекомендуем
отзыв: отзыв
один: одно одним
оценка: оценки
иметь: имеет
оба: оба
опухоль: опухоли
флора: флоры
размножение: размножению
что: что чем
выявить: выявить
слуховой: слухового слуховой слуховом
зуд: зуд
тип: типа
оценить: оцените
домашние: домашних
грибковый: грибковые
ожидать: ожидают
сторона: сторону
возникать: возникают
часто: часто
некоторые: некоторыми некоторых
реж: реже
описывать: описывает
промывание: промывание
если: если
инфекция: инфекции инфекцию
тереть: три
процесс: процесс
любой: любое
основа: основе
осложнение: осложнения осложнений
организм: организмов
противогрибковый: противогрибковые
из: из
трение: трение
выстилать: выстилает
ветеринарный: ветеринарному
ранний: ранней
противовоспалительный: противовоспалительные
среди: среди
внутри: внутри
бактериальный: бактериальные
многие: многих
получить: получить
фон: фоне
через: через
заказ: заказ
фактор: факторам
становиться: становится
результат: результатом результате
различный: различных различной
связанный: связанные
влиять: влияет влияющее
большой: большое
назначать: назначаемые
являться: является
затронуть: затронуты затронутого
бывать: бывают
последующий: последующему последующего
животное: животных
из-за: из-за
распространить: распространен
увеличивать: увеличивает
обратиться: обратиться
собака: собак
характерный: характерные
эффективность: эффективность
лечение: лечения лечение
повторный: повторном
который: которая
поэтому: поэтому
хронический: хронического
вызывать: вызывает
любимец: любимца
провести: проведено
семя: семян
это: этого это
поддерживать: поддерживающим
сопутствовать: сопутствующего
тщательный: тщательного тщательное
сеттер: сеттер
ограничить: ограничить
воспалительный: воспалительный
случай: случаях
продолжительный: продолжительное
предрасполагать: предрасполагают
спровоцировать: спровоцировать
его: его
неприятный: неприятный
диагностировать: диагностирован
системный: системное
ветеринар: ветеринар
средний: среднего
питомец: питомца
перепонка: перепонку перепонки
страхование: страхование
кожный: кожное кожные
или: или
затрата: затрат
мы: мы
слизистая: слизистая
на: на
топ: топе
подозрение: подозрениях
минимум: минимумом
наиболее: наиболее
указать: укажите
мазок: мазка
хороший: лучшее
маленький: малейших
поздний: позднее
почта: почту
вызвать: вызвать вызван
когда: когда
баланс: баланса
внешний: внешнего
появление: появления
длить: для
нарушение: нарушения
количество: количество
страховка: страховку
либо: либо
общий: общий
состояние: состояния
даже: даже
от: от
переходить: переходите
взятие: взятием
выполнить: выполнить
дерматологический: дерматологическим
способствовать: способствует
наблюдаться: наблюдается
как: как
обструкция: обструкции
воспаление: воспаление
ваш: вашего вашей ваш
проход: проход прохода
подключить: подключить
так: так
по: по
плохой: плохой
рекомендация: рекомендациями
голова: головы
возникнуть: возникнуть
развиваться: развиваться
рецидив: рецидива
склонный: склонные
барабанный: барабанную барабанной
травма: травма
считаться: считается
потребоваться: потребоваться
распространение: распространением
попадание: попадании
узкий: узкий
риск: риск
проникать: проникает
очень: очень
аномальный: аномальному
способ: способов способ
высокий: выше
товар: товар
какой: какие
наличие: наличие наличии
выбирать: выбирайте
признак: признаки
медленный: медленно
быть: быть будет
переть: при
