поездка: поездки поездка поездке
специальный: специальное специальном специальным специальный
нервничать: нервничает
бензин: бензина
раздражение: раздражение
день: дней дни
таблетка: таблеток
поведение: поведение
найти: нашедшему
прогулка: прогулки
еще: еще
пакетик: пакетик
выйти: выйти
любить: любимыми любимым любимого
свести: свести
позаботиться: позаботиться
обзор: обзора
подцепить: подцепить
лапа: лап
воды: воды
путешествие: путешествие
удар: удар
прикрепить: прикрепите
важный: важно важный
народный: народным
живот: животе
неагрессивный: неагрессивный
полный: полна
грибок: грибок
рюкзак: рюкзаки
нести: несет
помощь: помощью
аллергия: аллергии
вода: водой
а: а
человек: людей
дополнительно: дополнительно
машинка: машинке
скрести: скребет
в: в
заболевание: заболеваниям
панический: панически
содержание: содержание
пункт: пункт
и: и
качественный: качественных
к: к
о: о
поезд: поезде
с: с
она: она нее
средство: средства средств
у: у
нога: ногах
подушечка: подушечек
шампунь: шампуня шампуни
сезон: сезон
они: них они
клещ: клещей клеща
владелец: владелец владельца владельцы
оно: оно
добыть: добыть
природа: природе
вариант: вариант
наступить: наступит
обеспечить: обеспечить
пройти: прошла прошло
водитель: водитель
сложность: сложности
теперь: теперь
необходимый: необходимое
бояться: бояться
раздвинуть: раздвинуть
расположить: расположите
автомобильный: автомобильный автомобильную
развлечь: развлечь
употребление: употреблении
время: время
конец: конце
забыть: забудьте
поощрение: поощрение
очищение: очищение
внутренний: внутренних
погладить: погладить
сильный: сильно
автоматический: автоматической
ситуация: ситуаций
также: также
вблизи: вблизи
туда: туда
корма: корм корма
индивидуальный: индивидуально
появиться: появится
получение: получения
хвалить: хвалите
следовать: следует
легко: легко
предварительно: предварительно
написать: напишем
трава: траве
надевать: надевать
прийтись: придется
пытаться: пытайтесь пытаясь
зависимость: зависимости
электричка: электричке электричку
наконец: наконец
начать: начать
добрый: добрый
комфортно: комфортно
обожать: обожает
устанавливаться: устанавливается
обеспечивать: обеспечивать
отсутствие: отсутствие
мячик: мячик
однако: однако
себя: себя собой
заводиться: заводятся
рекомендоваться: рекомендуется
намордник: намордник
система: система
угощение: угощения
рекомендовать: рекомендуем
крепкий: крепким
отзыв: отзыв
успокаивать: успокаивающее
пластиковый: пластиковой пластиковые
один: один одну
повреждение: повреждений
оценка: оценки
обязательно: обязательно
иметь: имеют иметь
полностью: полностью
помыть: помойте
сыпаться: сыпятся
громкий: громко
оценить: оцените
чесаться: чесаться
последний: последний
медикамент: медикаментов
дорогой: дорога дороги
часто: часто
момент: момент
крепиться: крепится
лето: летом
некоторые: некоторые
помочь: поможет
труд: труда
проезд: проезду
лаять: лает
середина: середине
плесень: плесень
укус: укусы
окошко: окошком
курс: курс
метод: методам
подвести: подведем
кожа: коже кожу
негативный: негативно
ошибочно: ошибочно
обработать: обработали обработать обработайте
комфортный: комфортнее комфортному
накопительный: накопительный
номер: номер
через: через
вечер: вечеров
замена: замена
приучить: приучите
врач: врачу врачом
превышать: превышать
коготь: когтями когтей
особенно: особенно
большой: велик
штука: штук
поставить: поставить
должен: должна должно
конечно: конечно
заразить: зараженными
животное: животными животного животных
мешать: мешал
копать: копать
открывать: открывать
мисочка: мисочки
подготовка: подготовки подготовка
салфетка: салфетки
нужно: нужно
достаточно: достаточно
возможно: возможно
отличный: отличный
актуально: актуально
нежный: нежную
почва: почвой
вызывать: вызывают
порция: порцию
провести: провести проведена
это: это
обработка: обработка обработки
прочный: прочным
поддерживать: поддерживают
ответственность: ответственность
предусмотреть: предусмотрена предусмотрено
обнаружить: обнаружить
ошейник: ошейников ошейник
сказаться: сказаться
покрытие: покрытием
суспензия: суспензий
взять: взять
отмерить: отмерить
его: его
эффект: эффект
только: только
дегельминтизация: дегельминтизацию
тошнить: тошнит
капля: капель
ухудшить: ухудшить
средний: средних
дорога: дороге дорогу
заражение: заражение
держать: держать
периодический: периодически
пеленка: пеленкой пеленки
или: или
крем: крем кремом
сожаление: сожалению
точно: точно
необработанный: необработанных
воздействие: воздействию воздействие
считать: считают
минимум: минимуму
уход: уход
привить: привить
хороший: хорошая лучше хорошее
много: много более
пристегивание: пристегивания
грудь: груди
когда: когда
крупинка: крупинки
застелить: застелить
играть: играть играя
вкусный: вкусными
значит: значит
рассчитать: рассчитан
учитывать: учитывать
ждать: ждет
повторно: повторно
контейнер: контейнере контейнер
химчистка: химчистке
испачкаться: испачкаться
дача: дачу даче
заразиться: заразиться
состояние: состояние
наверняка: наверняка
итог: итоги
захватить: захватить захватите
приобрести: приобрести приобретите
планироваться: планируется
вопрос: вопрос
приоткрыть: приоткрыть
поскольку: поскольку
компания: компанией
вспомнить: вспомните
размер: размерах
лапка: лапки
предъявлять: предъявляемыми
ваш: ваш вашей
так: так
главное: главное
мнение: мнение
прибегать: прибегая
иногда: иногда
четвероногий: четвероногий четвероногого четвероногим
ведь: ведь
протереть: протереть
вентиляция: вентиляции
постараться: постарайтесь
зайти: зайти
привыкнуть: привык
использование: использованием
самый: самый самым
материал: материалов
товар: товар
быть: будет была быть
общественный: общественном
шерсть: шерсть
автомобиль: автомобиле автомобиль автомобиля
приспособление: приспособление
успокоительный: успокоительного
мерный: мерного
черный: черные
вести: ведет
есть: есть
пахнуть: пахнет
представлять: представлять
долговечный: долговечных
установить: установить
транспорт: транспорте
ряд: ряд
мочь: может могут мог
этот: эта
замок: замком
друг: друг
перевозка: перевозки перевозка
приход: прихода
убивать: убивают
амуниция: амуниция амуницию
правило: правилами
иммунитет: иммунитет
гельминт: гельминтами
сэкономить: сэкономить
ознакомиться: ознакомиться ознакомьтесь
стресс: стресс
поддон: поддоном
фиксировать: фиксировать
можно: можно
дать: данный дайте
возможный: возможна
мыться: моются
долгожданный: долгожданный
подстилка: подстилку
минимальный: минимальным
элемент: элементов
гарантия: гарантия
во: во
дата: дату
извинить: извините
вакцинация: вакцинации
раз: раз
того: того
суточный: суточного
вы: вы вам
оставить: оставьте
одноразовый: одноразовой одноразовые
паспорт: паспорт
солнечный: солнечный
отвлечь: отвлечена
необходимо: необходимо
обойтись: обойтись
переборщить: переборщите
тест: тест
порой: порой
просьба: просьбой
противоскользящий: противоскользящим
тем: тем
чтобы: чтобы
спокойствие: спокойствие спокойствия
рацион: рациону рациона
контактировать: контактировать
без: без
предупреждать: предупреждают
перед: перед
шерстить: шерсти
плавно: плавно
перевозить: перевозить
до: до
слегка: слегка
наблюдать: наблюдаете
останавливаться: останавливайтесь
альтернатива: альтернатива
мытье: мытья
мелкий: мелких
адрес: адрес
другой: другим других другие
представить: представленных
давать: дает
воск: воск воском
вовремя: вовремя
ее: ее
полотенце: полотенце
нефтепродукт: нефтепродуктов
телефон: телефона
тканевый: тканевой тканевые
пригодиться: пригодятся пригодится
посол: после
сухой: сухой
складываться: складываются
профилактический: профилактических
защищать: защищает
забрасывать: забрасывайте
пищать: пищащих
знать: знаете
причина: причинам
стойкий: стойкий
повредить: повредить
жаркий: жаркие
вид: виде вид видом
достать: достать
производиться: производятся
же: же
кроме: кроме
дно: дно
что: что
зуд: зуд
за: за
предмет: предметов
паразит: паразитов паразит
домашний: домашнего
неожиданность: неожиданностей
форма: форме
спрятать: спрятать
вычесать: вычесать
дом: дом домом
ожидать: ожидают
поверхность: поверхности
бутылочка: бутылочки бутылочку бутылочка
попить: попить
лакомство: лакомств лакомства
зависеть: зависит
набор: набором
процедура: процедура
если: если
хозяин: хозяину
ассортимент: ассортименте
любой: любой
захотеть: захочет
кусочек: кусочки кусочками
из: из
здорово: здорово
изделие: изделием изделия изделие
наш: наши нашем
ветеринарный: ветеринарному ветеринарную ветеринарным ветеринарный
обстановка: обстановки
серьезный: серьезных
многий: многое
удобный: удобной удобны удобным
их: их
аптечка: аптечку аптечка
пересыпать: пересыпать
получить: получить
многие: многие
очищать: очищают
контакт: контакте
насекомое: насекомые
заказ: заказ
зимой: зимой
игрушка: игрушка игрушки
автобус: автобусе
угощать: угощайте
салон: салона
сделать: сделайте сделать
дорожный: дорожной дорожные
здоровье: здоровье
транспортировка: транспортировка
загородный: загородном
влажный: влажной влажный влажные
засунуть: засунуть
испытывать: испытывает
белый: белое
защитить: защитить
гранула: гранулы
обратиться: обратиться обратитесь
собака: собак собака собаку собаки собакам
клиника: клинику
кустарник: кустарников
приходиться: приходится
нетерпение: нетерпением
поводок: поводке поводок
вноситься: вносится
неплохой: неплохой
безопасность: безопасность безопасности
хитрость: хитрость
который: которые которое которых который
поэтому: поэтому
холка: холку
чистота: чистоты
участок: участке
крупный: крупных
например: например
любимец: любимца любимец любимцев
следующий: следующую следующий
вне: вне
подобрать: подобрать
подолгу: подолгу
крайний: крайнем
выбрать: выбрать
питье: питья
рассказать: расскажем
пропустить: пропустить
случай: случае
сразу: сразу
напиться: напившийся
прививка: прививок
жизнедеятельность: жизнедеятельности
путешествовать: путешествовать путешествуете
такой: такой
понять: понял
деть: дело
нужный: нужен
текстильный: текстильное
облегчить: облегчит
несколько: несколько
питомец: питомец питомцу питомцы питомца питомцев
отвлекаться: отвлекаться
безопасно: безопасно
место: место места
перевозчик: перевозчиком
ремень: ремнем ремень
располагаться: располагается
рука: руку
ссадина: ссадин
летний: летних летние
мы: мы
на: на
совершенно: совершенно
тот: том
стирка: стирка
комната: комнате
не: не
ранка: ранки
использовать: использовать
образоваться: образуются
самостоятельно: самостоятельно
задний: заднем заднее
шлейка: шлейка шлейку
указать: укажите
кровь: крови
содержать: содержит содержащий
миска: миски
но: но
маленький: маленькую
почта: почту
осуществляться: осуществляться
выпускаться: выпускаются
обеспечение: обеспечения
тряпка: тряпкой
реагент: реагентов
внешний: внешних внешний
сидение: сидении сидение
появление: появление
длить: для
карабин: карабином
начинать: начинает
количество: количество
надлежащий: надлежащем
туалет: туалет
модель: модель моделях
увеличиваться: увеличивается
составить: составит
обратить: обратить
понадобиться: понадобится понадобятся
он: он него нему
от: от
бегать: бегать
предельно: предельно
регулироваться: регулируются
несложно: несложно
блоха: блох
пассажир: пассажиров пассажиры
как: как
помять: помните
вернуть: вернуть
внимание: внимание
принимать: принимать
все: всех
препарат: препараты
обивка: обивку
гололед: гололеда
убежать: убежит
возможность: возможности возможность
совок: совка
по: по
оснастить: оснащены оснащенном
устойчивый: устойчивы
защитный: защитным
осмотреть: осмотрите
информация: информация
занять: займут
подготовить: подготовьте
травма: травм
опасный: опасным
риск: риск
подбираться: подбираются
порода: пород
способ: способ
высокий: высокой
забывать: забывайте
какой: какому
нервный: нервной
наличие: наличие наличии
непредвиденный: непредвиденных
грядка: грядки
продукт: продуктов продукты
произойти: произошло
проверить: проверьте
переносок: переноске переноски переносок переноску
заранее: заранее
переть: при
