автомобиль: автомобиля
поездка: поездок
оторвать: оторванной
поворачиваться: поворачиваться
ветеринарный: ветеринарный
сиденье: сиденье
новый: новым
их: их
комфортный: комфортного
прогулка: прогулки
происходить: происходить
качество: качестве
заказ: заказ
любить: любимую
игрушка: игрушки игрушку
внутрь: внутрь
мочь: может могла могут
взрослый: взрослую
этот: этой
приучить: приучить
врач: врач
настолько: настолько
важный: важно
различный: различных
встречаться: встречаюсь
конфликт: конфликты
сходить: сходить
поставить: поставить
должен: должна должен
а: а
в: в
стоять: стоять
и: и
к: к
комфортабельный: комфортабельным
усилие: усилий
можно: можно
увеличивать: увеличивайте
временить: времени
собака: собака собаки собак собаку собакой собаке
с: с
она: она нее ней
положительный: положительное положительные
стать: стать
использоваться: используется
достаточно: достаточно
безопасность: безопасность
во: во
ассоциироваться: ассоциироваться
который: которые
я: я
уже: уже
бросать: бросайте
провести: проведенное
следующий: следующим следующими
вы: вами вы
это: это этим
свободно: свободно
оставить: оставьте
бояться: бояться
необходимо: необходимо
расположить: расположите
выбрать: выберите
забираться: забираться
вот: вот
чувствовать: чувствовать чувствовала
время: время
ограничить: ограничить
вполне: вполне
создавать: создавайте
путешествовать: путешествуете
такой: такая
остальной: остальной
правильный: правильный правильном правильных
проблема: проблемой
свое: своего
создание: создания
чтобы: чтобы
также: также
несколько: несколько
питомец: питомца
пребывание: пребыванием
появиться: появится
место: места местом место
начало: начала
получение: получения
оставлять: оставлять
без: без
или: или
необходимость: необходимость
евгения: евгения
следовать: следуйте
удобно: удобно
полезный: полезна
отдых: отдыха
мы: мы
присмотр: присмотра
положить: положите
приучение: приучения приучение
на: на
находиться: находится
прилагать: прилагаете
адрес: адрес
другой: другими
тот: то
клетка: клетка клетке клетку
знакомить: знакомьте
использовать: использовать используйте используете
не: не
задний: заднем
требовать: требует
указать: укажите
давать: давайте
оставаться: оставайтесь
ее: ее
выставка: выставках
но: но
много: более
обеспечивать: обеспечивает
почта: почту
привычный: привычные
когда: когда
играть: играйте
длить: для
затем: затем
себя: себя
защищать: защищает
начинать: начинайте
угощение: угощениями
рекомендовать: рекомендуем
отзыв: отзыв
кроме: кроме
он: он
постепенно: постепенно
приятный: приятными
поделиться: поделюсь
от: от
оценка: оценки
совет: советами
ассоциировать: ассоциировать
отдыхать: отдыхать
что: что
как: как
уютный: уютное уютного
первое: первое
сталкиваться: сталкиваются
размер: размер
за: за
оценить: оцените
ваш: ваша вашей ваш
так: так
поощрять: поощряйте
по: по
рекомендация: рекомендациями
ожидать: ожидают
где: где
приучать: приучайте
безопасный: безопасное
минута: минут
занять: занять
травма: травмах
зачем: зачем
часто: часто
наслаждаться: наслаждаться
привыкнуть: привыкнуть
использование: использования
статья: статье
если: если
подвижность: подвижность
способ: способ
товар: товар
наличие: наличии
терпеливый: терпеливым
процесс: процесс
захотеть: захочет
быть: быть будет
переть: при
что-то: чем-то
