долгий: долгой долгие
специальный: специальной специальная
нитрат: нитраты
день: дней
металл: металлы
найти: найти
служить: служат
еще: еще
видовой: видовые
владение: владения
ребенок: детей
обзор: обзоре
лапа: лапы
воды: воды
со: со
важный: важна важен важно
касаться: касается
охранять: охраняют
под: под
стабильный: стабильнее стабильны
помощь: помощью
а: а
в: в
композиция: композиций композиции
содержание: содержание содержания
отказаться: откажется
поделить: поделить
и: и
живой: живыми
к: к
с: с
средство: средства
у: у
относить: относят
определить: определенных
они: них ним
собрать: собрать
вариант: вариант
мир: мира мир
входить: входит
этап: этапе
аммиак: аммиак
опытный: опытных
небольшой: небольшая небольших
время: временем
непригодный: непригодные
загрязнение: загрязнений
кондиционер: кондиционер
любоваться: любоваться
подарок: подарка
компрессор: компрессор
также: также
появиться: появится
получение: получения
час: часа час
написать: напишем
сосед: соседа
света: света
требовать: требуют
комфортно: комфортно
биологический: биологической биологическая
сиамский: сиамский
обеспечивать: обеспечивает
дискомфорт: дискомфорт
требоваться: требуется
задача: задачи
хотя: хотя
слой: слой
освещение: освещение
себя: себя
устанавливать: устанавливать
мирный: мирная
рекомендоваться: рекомендуется
система: система
тяжелый: тяжелые
отзыв: отзыв
прямая: прямые
надеяться: надеемся
постепенно: постепенно
один: один одного
оценка: оценки
совет: советами советы
снизить: снизит
интересный: интересные интересны
длина: длины
жесткий: жесткими
хлор: хлор
оценить: оцените
некоторые: некоторые
помочь: помогут
удаление: удаление
описание: описание
желательно: желательно
избежать: избежать
процесс: процессы
растенье: растений
запустить: запустить
техник: техника
градус: градуса
среди: среди
батарея: батареи батарей
нарушить: нарушить
нитрит: нитриты
комфортный: комфортную
развивать: развивают
качество: качестве
взрослый: взрослых взрослой
экосистема: экосистема
жизненно: жизненно
становиться: становится
перепад: перепады
отдельный: отдельный отдельные
выглядеть: выглядят
новичок: новичков
должен: должна должно
наоборот: наоборот
хотеть: хотят
фильтр: фильтр фильтром
подготовка: подготовка
нужно: нужно
стать: стать
заселять: заселяйте
это: это этом этому
поддерживать: поддерживать поддерживает
большинство: большинства большинство
зеленый: зеленой
ответственность: ответственность
цвести: цветет
рост: роста
два: две
петушок: петушок
прямой: прямо
чешуя: чешуя
стоить: стоит
стабильность: стабильность
консультация: консультацией
его: его
красивый: красивых
только: только
жизнь: жизни
сантиметр: см
менять: менять
нарастать: нарастать
тумба: тумбы тумба
подмена: подмены
средний: средние среднем
функция: функция
или: или
водоросль: водорослей водоросли
чаща: чаще
уход: уход
хороший: лучше хороший
спокойный: спокойное
органический: органических
аквариум: аквариум аквариума аквариумах аквариуме аквариумы аквариумом
много: более
окно: окном
когда: когда
значит: значит
учитывать: учитывать учитывайте
болезный: болезней
учесть: учесть
равномерно: равномерно
болезнь: болезни
первый: первую
лист: листьями
ошибка: ошибок
объединять: объединяет
искусственный: искусственными
перерасти: перерастет
установка: установка установки
размер: размеру размера
предъявлять: предъявляют
именно: именно
ваш: ваши вашей ваш
так: так
иногда: иногда
рекомендация: рекомендации
развиваться: развиваются
где: где
больший: больше больший большее большие большего
тропический: тропических тропический
потребоваться: потребуется
позволять: позволяют позволяет
использование: использования
неделя: недель
счастливый: счастливее
самый: самая
товар: товар
выбирать: выбирать выбирайте
быть: будет будут быть
аквариумный: аквариумных
отопительный: отопительными
частота: частота
нагрузка: нагрузка
пруд: пруду
есть: есть
угол: углу
конкуренция: конкуренции
установить: установить
бактерия: бактерии
ряд: рядом
попадать: попадают
мочь: могут может
месяц: месяца
этот: эта
объем: объема объем
четыре: четыре
подключение: подключения
нагреватель: нагреватель
оформлять: оформлять
сохранить: сохранит
аквариумист: аквариумистов аквариумиста
стресс: стресса
кислород: кислородом
можно: можно
увлечение: увлечение
темперамент: темперамент
позволить: позволит позволят
смочь: сможет смогли
насыщать: насыщает
извинить: извините
базовый: базовые
сомневаться: сомневаетесь
очередь: очередь
того: того
вы: вам вы вас
магазин: магазине
оставить: оставьте
обитатель: обитателями обитатели обитателей
солнечный: солнечные
стол: стол
лучить: лучи
обитание: обитания
чудо: чудо
условно: условно
чувствовать: чувствует
растение: растения растениями
дыхание: дыхание
простой: простые
свой: свою
прощать: прощают
свое: свои своего
требование: требования
тем: тем
чтобы: чтобы
рацион: рацион
без: без
правильно: правильно
между: между
связать: связать
до: до
увеличить: увеличить
особенность: особенности
мелкий: мелкой
адрес: адрес
другой: другие
рыба: рыбу рыб рыбы
креветка: креветки
оставаться: оставались
рабочий: рабочее
собственный: собственного
питание: питания
растительноядный: растительноядными
период: период
параметр: параметры параметров
знать: знать
центральный: центрального
причина: причиной
повредить: поврежденные
вид: виды видами
кроме: кроме
ободрать: ободранная
плавник: плавники
отопление: отопления
вдохновение: вдохновения
превращаться: превращаться
диапазон: диапазоне
поднять: поднимут
что: что чем
за: за
рыбка: рыбки рыбок рыбками рыбка рыбкам
домашний: домашнее
ожидать: ожидают
нитчатый: нитчатые
стайка: стайка стайку стайки
растительный: растительный
залог: залог
настоящее: настоящее
зависеть: зависит
набор: набор
существовать: существует
если: если
эффектный: эффектно
принцип: принципы
отстаивать: отстаивать
украсить: украсить
избыток: избыток
из: из
красота: красоту красоты
наш: наши
распад: распада
их: их
перенаселять: перенаселяйте
очищать: очищают
выполняться: выполняется
близкие: близких
напоминать: напоминают
территориальный: территориальные
заказ: заказ
розетка: розетки
письменный: письменный
покупка: покупке покупкой покупки
вдали: вдали
прибор: приборами
сделать: сделает
съесть: съесть
здоровье: здоровье здоровья
разный: разными
механический: механических
здоровый: здоровыми здоровой
проглотить: проглотить
год: годы
географический: географического
обратиться: обратитесь
забота: заботы
мирно: мирно
деталь: деталям
который: которое которые которым который
поэтому: поэтому
краткий: кратком
крупный: крупную
например: например
знание: знаний
привести: приведет
промежуток: промежуток
выбрать: выбрать
запуск: запуском запуска
случай: случае
температура: температуру температуры
создать: создадут создать
такой: таких таким
понять: понять
деть: дело день
строгий: строгие
вместе: вместе
правильный: правильная правильного правильнее
стен: стены
жить: живут жили
вод: вода воду
нужный: нужных
создание: создание создания
место: места место
очистки: очистки
регион: региона
благодаря: благодаря
широкий: широком
мы: мы
перечислить: перечисленное
на: на
тот: том то
комната: комнаты
комплект: комплект
выбор: выбор выборе выбора
не: не
использовать: использовать используют
каждый: каждого каждый
губка: губке
указать: укажите
содержать: содержать
золотой: золотые
декорация: декорациями
маленький: меньше маленькое
но: но
почта: почту
длить: для
подводный: подводный
количество: количество
отстаивание: отстаивании
заключение: заключение
тина: тину
обратить: обратите
разогреть: разогретые
развитие: развитию
он: него он
даже: даже
поделиться: поделимся
от: от
соединение: соединений
избегать: избегать
холод: холодов
причинять: причинять
как: как
первое: первых
внимание: внимания внимание
все: всего
препарат: препаратов
условие: условия
по: по
сократить: сократить
занимать: занимать
травма: травм
соотношение: соотношение
немой: нем
опасный: опасных опасные
оборудование: оборудование
риск: риски
очень: очень
выводиться: выводятся
способ: способ
какой: какой какое каких
наличие: наличии
второе: вторым
продукт: продукты
источник: источником
переть: при
