бантик: бантики
новый: новых новое новый
найти: нашедший
письмо: письмо
еще: еще
прогулка: прогулке прогулку прогулки
любить: любимой любят любимых любящих
лапа: лапы
мусс: муссы мусс
воды: воды
со: со
путешествие: путешествия путешествиях
важный: важно
касаться: касается
наряд: наряды
под: под
встретить: встретит
рюкзак: рюкзаке
пол: полу
аллергия: аллергии
а: а
дополнительно: дополнительно
человек: человеку
в: в
содержание: содержание
и: и
к: к
сушеный: сушеные
о: о
подходить: подходят
коллекция: коллекциях
утиный: утиные
вероятность: вероятность
с: с
она: она
средство: средства
у: у
преподнести: преподнести преподнесите
запах: запах
они: им они них ними
знакомый: знакомый знакомых
дополнительный: дополнительное
домик: домик домика домики
владелец: владельцу владельцы владельце владельцев
местонахождение: местонахождением
вариант: вариант варианты
мальчик: мальчика
структура: структуры
теперь: теперь
джентльмен: джентльмен
цветной: цветных
слишком: слишком
небольшой: небольшие небольшим
конец: конце
время: время
забыть: забудьте
милый: милее
вечеринка: вечеринке
прорезиненный: прорезиненным
подарок: подарка подарок подарки
сильный: сильных
режим: режиме
порадовать: порадовать
скрасить: скрасить
также: также
член: члены
появиться: появилась появится
получение: получения
поддержание: поддержания
понравиться: понравятся понравится
туалетный: туалетная
прием: прием
удобно: удобно
написать: напишем
зависимость: зависимости
профессионал: профессионалам
обожать: обожают
мороз: морозах
приходить: приходит
дискомфорт: дискомфорт
мячик: мячики
короткошерстный: короткошерстных короткошерстные
часы: часов
девочка: девочки
укромный: укромных
тяжелый: тяжелого
сквозняк: сквозняков
рекомендовать: рекомендуем
отзыв: отзыв
очаровательный: очаровательной
волноваться: волноваться
приятный: приятный
один: один
оценка: оценки
оттенок: оттенков
иметь: иметь
полностью: полностью
совет: советы
полноправный: полноправные
собачка: собачки собачкой
громкий: громких
оценить: оценят оценит оцените
смотреться: смотрится
грязь: грязи
сумка: сумки
повернуть: повернуть
беспроигрышный: беспроигрышный
часто: часто
надеть: надеть
подарочный: подарочный
помочь: помогут
бренд: бренда бренд
обувь: обувью
погонять: погонять
избежать: избежать
потерять: потерять
бонус: бонус
курица: курицы
делать: делает
кольцо: кольцами
низом: низом
комфортный: комфортнее комфортный
номер: номер
качество: качестве
серый: серые
прохлада: прохлады
подойти: подойдут подойдет
прочить: прочь
оформление: оформление
нравиться: нравятся
вставка: вставкой
скучный: скучный
доставлять: доставлять
особенно: особенно
должен: должна должен
бывать: бываете бывают
курточка: курточки
получать: получает
никогда: никогда
новогодний: новогодней новогодний
животное: животного
хотеть: хотят
мисочка: мисочек
салфетка: салфетку
стать: станут станет
достаточно: достаточно
придавать: придают
чаять: чает
актуально: актуально
костюмчик: костюмчиком
совместный: совместных совместные
вызывать: вызывают вызывать
травмировать: травмируют
это: это
прочный: прочного прочную
вкус: вкусом
код: код
еда: еды
ошейник: ошейникам ошейник
молодая: молодых
светящийся: светящиеся
синий: синий
вряд: вряд
взять: возьмите
стоить: стоит
его: его
красивый: красивыми красивых
только: только
менять: менять
нельзя: нельзя
улица: улицы
разнообразие: разнообразие
твердый: твердой
или: или
звук: звуки звуков
ненавязчивый: ненавязчивый
возраст: возраст
память: памяти
особо: особо
идеально: идеально
точно: точно
теплый: тепла
защита: защитой
считать: считаете
воздействие: воздействия
уход: уход уходу
почему: почему
невероятно: невероятно
хороший: лучше
замерзать: замерзают
тренировка: тренировки
прятаться: прятаться
объект: объектом
когда: когда
играть: играть
тематический: тематические
учитывать: учитывайте
ботиночек: ботиночки
подарить: подарить
забавный: забавные забавных
настроение: настроения
ошибка: ошибок
приобрести: приобрести
спальный: спальное
носок: носки носке
выполнить: выполнены
мягкий: мягкие
утепление: утепление
игра: игр
всеобщий: всеобщего
отдыхать: отдыхать
уютный: уютное
ориентироваться: ориентируйтесь
размер: размер
перетягивание: перетягивание
вяленый: вяленые
жилетка: жилетки
ваш: ваш ваших вашего вашей
так: так
светоотражающий: светоотражающие
уместиться: уместиться
четвероногий: четвероногий четвероногих четвероногие четвероногим четвероногого
голова: голову
больший: больше
кто: кто
томительный: томительное
активный: активных
попадание: попадания
привыкнуть: привыкли
самый: самые
материал: материалов материала
товар: товар
выбирать: выбирайте выбирая
лабиринт: лабиринты
быть: быть будут будет было
общественный: общественных
пластинка: пластинки
шерсть: шерстью
тоже: тоже
носочек: носочки носочков
финальный: финальным
темный: темное
черный: черные
электронный: электронную
долька: дольки
косточка: косточки
мочь: может
этот: эти этот
уверить: уверены
друг: друга
отлично: отлично
стрижка: стрижки
издавать: издает
ловкость: ловкости
основной: основную
иммунитет: иммунитета
неудобство: неудобств
бы: бы
трепать: трепать
можно: можно
основное: основное
снег: снега
элемент: элементом
штрих: штрихом
готовый: готовые готовых
интерактивный: интерактивные
уже: уже
извинить: извините
очередь: очередь
того: того
вы: вы вас вам
оставить: оставьте
необходимо: необходимо
уголок: уголках
испугаться: испугаться
простой: прост
сутки: суток
смотреть: смотрите
декор: декора
щенок: щенкам
свой: своей свою
розовый: розовый
тем: тем
популярный: популярны
чтобы: чтобы
привередливый: привередливые
шерстить: шерсти
дома: дома
перевозить: перевозить
комбинезон: комбинезоны
полезный: полезное полезными
представитель: представителей
особенность: особенности
положить: положить
адрес: адрес
представить: представлены
другой: другие
теплолюбивый: теплолюбивых
работа: работе
трек: треки
оставаться: остающимся
ожидание: ожидания
ее: ее
песик: песика песики песиков
пожилой: пожилые пожилых пожилым
вытянуться: вытянуться
телефон: телефона
пригодиться: пригодятся
интерьер: интерьер
пока: пока
посол: после
праздник: праздник
лежак: лежак лежака лежаки
кличка: кличку
украшение: украшением
знать: знает
вселенная: вселенной
прелестный: прелестный
превратиться: превратится
же: же
деликатный: деликатном
надежно: надежно
влагоустойчивый: влагоустойчивую
дополнять: дополняющий дополняющих
грызть: грызть
что: что чем
зуб: зубов зубы зубами
длительный: длительных
стильный: стильный стильные стильно
за: за
предмет: предметы
износостойкий: износостойкого
домашние: домашних
колбаска: колбаски
домашний: домашний
ожидать: ожидают
рукавица: рукавицы
лакомство: лакомствами лакомства
спальня: спальни
острота: остроту
набор: наборы набор наборов
процедура: процедур
если: если
статья: статьи
существовать: существует
схватить: схватить
современный: современные
хозяин: хозяину хозяин хозяев хозяина
эффектный: эффектный
любой: любого любым
ассортимент: ассортимент
оригинальный: оригинальный
из: из
изделие: изделий изделия
галстук: галстуки
наш: наши
предназначение: предназначение
случайный: случайной
медальон: медальоны
елочка: елочку
подставка: подставки
удобный: удобной удобную
их: их
мясо: мяса
вовсю: вовсю
вкусненький: вкусненьким
заказ: заказ
игрушка: игрушку игрушки
прибор: приборы
восторг: восторге
застежка: застежке
сделать: сделаны сделан
гость: гости
актуальный: актуальна
год: год
защитить: защитят защитит
пес: пса псу
прослужить: прослужит
собака: собаке собака собаки собакам собак
кухня: кухни
поводок: поводок
потеря: потери
который: которые которая котором который которыми которому
аромат: аромат ароматов
ухаживать: ухаживать
поэтому: поэтому
крупный: крупным
например: например
любимец: любимцем любимцев любимцам любимца
безмятежный: безмятежно
ли: ли
пища: пищи
универсальный: универсальный
наведение: наведении
выбрать: выберете
рассказать: расскажем
вот: вот
случай: случае случая
практичный: практичные практичный
инструмент: инструментов
перевернуть: перевернуть
температура: температурах
путешествовать: путешествует
такой: такой такую
полакомиться: полакомиться
вместе: вместе
отравление: отравления
ухудшать: ухудшают
примерка: примерку
вод: вода
текстильный: текстильные
несколько: несколько
надежный: надежной
питомец: питомцы питомцу питомца питомцам питомец питомцем питомцев
герой: героями
место: место местом местах
предпочитать: предпочитающим предпочитаете предпочитает
решение: решение
дух: духи
колесико: колесиках
собираться: собираетесь
проспать: проспать
натуральный: натуральных
душ: души
широкий: широкий
отдых: отдыха отдых
мы: мы
паштет: паштеты паштет
на: на
состав: составы
глаз: глаза
стирка: стирки
не: не
использовать: использовать
выбор: выбор выборе
самостоятельно: самостоятельно
каждый: каждый
шлейка: шлейка
указать: укажите
миска: мисок миска миски
содержать: содержит
смартфон: смартфона
модный: модным
утеплить: утепленная
но: но
почта: почту
обеспечение: обеспечения
реагент: реагентов
идеальный: идеальный
длить: для
мерзнуть: мерзнут
незаменимый: незаменим незаменима незаменимых
модель: модели модель
цветовой: цветовое
уровень: уровня
обратить: обратите
поиграть: поиграть
развитие: развития
он: ему он
семья: семьи
предлагать: предлагает предлагаем
даже: даже
от: от
предельно: предельно
длинный: длинной
невозможно: невозможно
холод: холода холодов
возражать: возражать
попробовать: попробуйте
как: как
обоняние: обоняния
внимание: внимания внимание
все: все всех
низкий: низких
убежать: убежит
возможность: возможность
по: по
веревка: веревками
безопасный: безопасны
информация: информацию
немой: нем
скоро: скоро
одежда: одежда
порода: пород
расцветка: расцветки
способ: способ
какой: какие какой
наличие: наличии
аксессуар: аксессуары аксессуар
яркий: яркие яркую ярким
переносок: переноска переноске переноску
переть: при
