поездка: поездках
затейливый: затейливой
витамин: витамины
отличительный: отличительных
специальный: специальный
ухо: уши ушей
служить: служат
еще: еще
происходить: происходящим
учет: учетом
любить: любят
физический: физической
ребенок: детьми
обзор: обзор
лапа: лапы
воды: воды
со: со
исключительный: исключительными
важный: важно важных
чужак: чужакам
доступ: доступа
охранять: охраняет
под: под
множество: множеством множество
пол: полу
перчатка: перчаток
а: а
человек: человека
щетка: щетке
в: в
трудный: трудно
содержание: содержание
и: и
качественный: качественным
кастрировать: кастрированных
помещаться: помещаться
к: к
о: о
подходить: подходящий подходящих
с: с
она: нее
средство: средства
у: у
применять: применяя
течение: течение
шампунь: шампунь
они: они них им
дополнительный: дополнительным
разборчивый: разборчива
домик: домик
мир: мире миру
гигиена: гигиену гигиены
необходимый: необходимые необходимого необходимы
абсолютно: абсолютно
калория: калорий
макроэлемент: макроэлементы
классический: классическая
быстро: быстро
поощрение: поощрением
забыть: забудьте
социальный: социальны
кондиционер: кондиционер
про: про
собраться: собралась
представительница: представительница
кормление: кормлению
сильный: сильный
также: также
корма: корма корм кормам
чистый: чистая
член: члену
игривый: игривый игривым
появиться: появится
свежесть: свежестью
получение: получения
поддержание: поддержания
италия: италия
комфорт: комфорт
понравиться: понравится понравятся
следовать: следуйте
комплексный: комплексную
мебель: мебели
предварительно: предварительно
прием: приема
легко: легко
написать: напишем
незаурядный: незаурядный
зубной: зубной
собачий: собачья
начать: начали
требовать: требуют
комфортно: комфортно
гребень: гребни
лоток: лоток лотке
дружелюбный: дружелюбный дружелюбны дружелюбное
сиамский: сиамской сиамских
ключевой: ключевые
древесный: древесный
разногласие: разногласий
подбирать: подбирайте
уменьшить: уменьшит
мячик: мячики
редкий: редкими
пятно: пятен
однако: однако
последствие: последствий
себя: собой себе
выгуливать: выгуливать
предназначить: предназначенные
укромный: укромное
скрещивание: скрещивания
рекомендовать: рекомендуем рекомендованную
отзыв: отзыв
хищник: хищнику
подшерсток: подшерсток
пересекаться: пересекается
купить: купите
соус: соусе
пластиковый: пластиковые
один: одной одного один
оценка: оценки
оттенок: оттенка
обязательно: обязательно
иметь: имеют иметь
заводной: заводные
молчаливый: молчалив
посетить: посетить
окрас: окрасов окрас
индейка: индейкой индейки
мера: мере
самостоятельный: самостоятельны
оценить: оцените
класс: классов класса
маскарадный: маскарадная маскарадных маскарадной маскарадные маскарадную
сторона: стороны сторону
активность: активности активностях
часто: часто
некоторые: некоторым
середина: середине
бренд: брендов
частый: частыми
тереть: три
описание: описание
разведение: разведением
налипать: налипать
делать: делая делает
курица: курицей
белка: белка
самочувствие: самочувствия
комфортный: комфортный
кишечник: кишечника
развивать: развивать развивающие
преимущество: преимущества
нрав: нрав нравом
сдержанность: сдержанностью
обустроить: обустроить
взрослый: взрослых взрослый
удивительно: удивительно
подойти: подойдет
врач: врачом
прочить: прочим
превышать: превышать
уют: уют
особенно: особенно
встречаться: встречается
большой: большого
должен: должно должна должен
бывать: бывают
повадка: повадками
чистить: чистить
наоборот: наоборот
различаться: различаются
салфетка: салфетки
стать: станет
достаточно: достаточно
независимость: независимость
нежели: нежели
закрепить: закрепленная
лазерный: лазерные
возможно: возможно
приобретать: приобретает приобретать приобретают
отрастание: отрастания
провести: проведет
переносить: переносят
это: это этом этого этим
обработка: обработку
мутация: мутация
большинство: большинство
поддерживать: поддерживать
ткань: ткани
еда: еде еды
два: две
молодая: молодая молодой
одинарный: одинарные
опираться: опирается
кот: котов кот
его: его
жизнь: жизни
только: только
двойной: двойные
менять: менять
разнообразие: разнообразие
держать: держать
линька: линьки
наполнитель: наполнителя наполнитель
или: или
ненавязчивый: ненавязчивы
возраст: возраст возрастов возраста возрасте
питьевой: питьевая питьевую
относиться: относятся относится
стеклянный: стеклянные
габарит: габариты
теплый: теплый
забраться: заберется
общение: общение общении
минимум: минимум
заводчик: заводчиков
уход: ухода уход
спокойный: спокойно
хороший: лучше хорошего
чувство: чувство
пыль: пылью
прятаться: прячутся
предотвратить: предотвратит
когда: когда
бельгия: бельгия
играть: играть
вкусный: вкусной
сеять: сей
значит: значит
красавица: красавицу
сибирский: сибирской сибирских
настороженность: настороженностью
настроение: настроения
норма: нормы норму
обязательный: обязательный
приобрести: приобрести
происхождение: происхождении
тогда: тогда
невский: невская невских невской невские невскую
стимулировать: стимулирует
набирать: набирает
поскольку: поскольку
путем: путем
специализированный: специализированным
аристократический: аристократическими
уютный: уютный уютное
лапка: лапках лапки
размер: размеров размерам
вычесывание: вычесывания
отойти: отойдет
линять: линяют
ваш: ваш вашего вашему вашей ваших
так: так
старший: постарше
там: там
иногда: иногда
четвероногий: четвероногой четвероного четвероногого
присутствовать: присутствуют
рекомендация: рекомендации
ведь: ведь
мыть: мыть
больший: большую
активный: активны активной
считаться: считаются
попадание: попаданию
зафиксировать: зафиксировали
предпочтение: предпочтение
фасовка: фасовках фасовка
участвовать: участвовать
товар: товар
выбирать: выбирают выбирая
быть: будет быть будут
шерсть: шерсть шерстью
вывести: выведенная
отмечать: отмечают
преданность: преданность
исходить: исходя
такт: такта
темный: темные темных
черный: черной черные
ген: гена
достаточный: достаточном
есть: есть
диалог: диалоги
внимательно: внимательно
пластик: пластика
навязчивый: навязчивого
разработать: разработаны
лишний: лишний
шубка: шубка
франция: франция
месяц: месяца
мочь: может можете
этот: этой этих эта эти
сам: самого
четыре: четыре
интеллект: интеллект
спора: споры
глубокий: глубокими
друг: друга
приход: приходом
дразнилка: дразнилки
обильно: обильно
ноготь: ногти
отлично: отлично
голубой: голубые
проявлять: проявляет
вообще: вообще
правило: правилам
основной: основных основная
стричь: стричь
иммунитет: иммунитет
кошка: кошка кошки кошек кошке
характер: характера характер
можно: можно
дать: данным
минерал: минералы
миронов: мироновой
возможный: возможных
век: века
стремление: стремление
ценить: ценят
производитель: производитель
комочек: комочков
во: во
готовый: готовые
вес: веса
интерактивный: интерактивные
опасно: опасно
признать: признана
хранение: хранения
морда: морде
голосовой: голосовые
извинить: извините
общительный: общительны
того: того
суточный: суточной суточную суточного
вы: вами вы вам
оставить: оставьте
расческа: расчески
обладательница: обладательница
испания: испания
наполнение: наполнению
проводить: проводить
аборигенный: аборигенная
необходимо: необходимо
соблюдать: соблюдать соблюдайте
версия: версий версия
россия: россии россия
личной: личное
понаблюдать: понаблюдать
зарегистрировать: зарегистрирована
чтобы: чтобы
густой: густой
гордость: гордость
тактичный: тактичны
здесь: здесь
рацион: рационы рацион рационов рационе рациона
без: без
голубоглазый: голубоглазая
привередливый: привередливых
плед: плед
необходимость: необходимости
шерстить: шерсти
дома: дома
между: между
героиня: героиней
до: до
лотковый: лотков
правый: право
представитель: представители представителей
особенность: особенности
руководство: руководством
ежедневный: ежедневное ежедневном ежедневные
мелкий: мелких
адрес: адрес
рыба: рыбой
чистка: чистки
другой: другой
весить: весь
популярность: популярность
обладатель: обладателей
оставаться: остается
давать: давайте
знаменитый: знаменитого
ее: ее
черта: черты черту
отдать: отдать
проконсультироваться: проконсультировавшись
пригодиться: пригодятся
регулярно: регулярно
сочетание: сочетание
питание: питание питания
сухой: сухие сухим сухой
посол: после
защищать: защищает
период: период
лежак: лежак
вычесывать: вычесывать
заполучить: заполучив
число: числе
вступать: вступают
ласковый: ласковый ласковая
же: же
кроме: кроме
хвостик: хвостик
упрямство: упрямство
сбалансированный: сбалансированным
всегда: всегда
купать: купать
керамический: керамические
уравновесить: уравновешены
что: что
светлый: светлого
эксперт: эксперта
зуб: зубьями зубы
править: правил
за: за
тип: типов
домашние: домашних
лосьон: лосьоне лосьоны
упражнение: упражнения
удовольствие: удовольствием
котенок: котята
рождаться: рождаются
поощрять: поощрять
маска: маски маской
форма: формам
дом: доме
ожидать: ожидают
спрятаться: спрячется
рукавица: рукавица
залог: залог
пространство: пространство
настоящее: настоящего
лакомство: лакомства лакомств
будто: будто
агрессивный: агрессивны
изготавливаться: изготавливаются
несмотря: несмотря
процедура: процедуры процедурам
статья: статьи
если: если
существовать: существует
хозяин: хозяина хозяевами
эффектный: эффектный эффектного
укусить: укусит
любой: любых любой
кусочек: кусочками
подвид: подвид
пушистый: пушистый пушистому
отношение: отношение
из: из
грациозный: грациозные
наш: нашей
красота: красоты
естественный: естественного
ветеринарный: ветеринарным
ольга: ольги
грамм: грамм
ранний: раннего
экстерьер: экстерьер экстерьера
подставка: подставками
их: их
породообразующий: породообразующий
многие: многих
хвост: хвост
заказ: заказ
резвиться: резвится
зачастую: зачастую
борт: бортами
игрушка: игрушек игрушки
сформировать: сформирована
длинношерстный: длинношерстных длинношерстным
вокализация: вокализации
следить: следите
салон: салон
тело: тело
заниматься: заниматься
здоровье: здоровья
гость: гостей
белые: белыми
котофей: котофей
обращать: обращайте
влажный: влажные влажным влажный
разный: разных разные
актуальный: актуальны
компаньон: компаньонов компаньону компаньона
окружить: окружена
ежедневно: ежедневно
год: года году лет
кг: кг
перекликаться: перекликаются
упаковка: упаковке
международный: международных международными
забота: заботу
поводок: поводками
унаследовать: унаследованные
малыш: малышам
глина: глины
который: которая
постоянный: постоянного
вывод: вывод
мордочка: мордочка мордочке
поэтому: поэтому
убрать: уберет
легкий: легкий
чистота: чистоте
награда: наградой
любимец: любимец любимца любимцев любимцу
пища: пищи
вылизывание: вылизывание
забивать: забивать
тщательный: тщательную тщательное
подбора: подборе
закупорка: закупорку
тайна: тайн
указка: указки
случай: случае
инструмент: инструменты
такой: такую такие такое
одиночество: одиночество
деть: день
привязываться: привязываются
развернуться: развернуться
строгий: строго
паста: пасте
оцарапать: оцарапает
вод: вода воду воде
нужный: нужны
текстильный: текстильные
создание: создания
облегчить: облегчат
несколько: несколько
питомец: питомцам питомца питомцев
атрибут: атрибут
начало: начала
место: места место
разбрасывание: разбрасывание
оптимальный: оптимальное
решение: решение
собираться: собираетесь
необычный: необычный
отдых: отдых
мы: мы
проточный: проточной
крайне: крайне
участие: участия
утверждать: утверждают
на: на
состав: составе
роскошный: роскошный роскошная роскошную роскошной
вестись: ведутся
тот: то тому том
глаз: глаз глаза
сводка: сводки
не: не
выбор: выбор
каждый: каждый каждому каждого
организация: организациями
шлейка: шлейки шлейка
сложно: сложно
указать: укажите
миска: миске миски мисок
усатый: усатых усатому
свободолюбие: свободолюбием
но: но
стерилизовать: стерилизованных
долголетие: долголетие
почта: почту
вызвать: вызвать
история: история
появление: появление
категория: категорий
длить: для
незаменимый: незаменимыми
ладить: ладят
количество: количестве количество количества
модель: модели
заключение: заключение
питомник: питомнике
влияние: влиянием
понадобиться: понадобятся
согласно: согласно
полоса: полосы
доказывать: доказывающие
он: ему
сдержать: сдержаны
семья: семьи семье
семью: семью
даже: даже
общаться: общаться
от: от
поистине: поистине
исторический: историческим исторические
официальный: официальное
придерживаться: придерживаться
длинный: длинной
способствовать: способствует
как: как
первое: первого первое
внимание: внимания внимание
все: всем все всего всему всех
игнорировать: игнорировать
возможность: возможность
по: по
деликатность: деликатностью
предотвращение: предотвращения
приучать: приучать
уникальный: уникален уникальным
склонный: склонной
огромный: огромное
ненужный: ненужной
врожденный: врожденное
информация: информация
подготовить: подготовили
фонтанчик: фонтанчик
одежда: одежде
очень: очень
порода: породы порода породой породам
скорый: скорее
способ: способ
высокий: высокий повыше высоких
забывать: забывайте
наличие: наличии
признак: признак признаков
обретать: обретаете
активно: активно
переносок: переноски переноску переноска
второй: вторая
переть: при
источник: источником
