бентонитовый: бентонитовый
долгий: долгое долго долгого
состоять: состоит
специальный: специальной
новый: новому новый
промышленный: промышленных
происходить: происходило
еще: еще
частично: частично
любить: любит
лапа: лапы
вокруг: вокруг
успех: успехи успех
со: со
важный: важно
древесина: древесины
противомикробный: противомикробными
монтмориллонит: монтмориллонита
пол: полах полу
аллергия: аллергий аллергия
производство: производства
а: а
в: в
подробный: подробнее
копатель: копателям
немного: немного
содержание: содержание
отказаться: отказаться
и: и
спрессовывать: спрессовывают
формироваться: формируются
к: к
подходить: подходящего подходящий подходит
о: о
она: она нее
с: с
у: у
течение: течение
запах: запахи запахов запахом запах запаха
они: них им они
дополнительный: дополнительных
знакомый: знакомых
кристалл: кристаллы кристаллами
домик: домики
земля: земле
экономичность: экономичность
вариант: варианта варианты вариант
сила: сил
домохозяйка: домохозяйки
подготовиться: подготовиться
распознать: распознать
активированный: активированный
дело: деле
входить: входит
слишком: слишком
небольшой: небольшими небольшую небольшие
время: время
быстро: быстро
загрязнение: загрязнения
миллиметр: мм
недавно: недавно
кремнезем: кремнезема
пробовать: пробуете
выбрасывать: выбрасывать выбрасывайте
потребовать: потребует
иной: иной
также: также
чистый: чистых чистую чистые чистого
туда: туда
член: члену
чистоплотный: чистоплотные
появиться: появится
получение: получения
оставлять: оставляют оставляя
прошлый: прошлого
понравиться: понравиться понравится
следовать: следуйте
удобно: удобно
легко: легко
написать: напишем
котик: котики котиком котик котику
образовываться: образовываться
прийтись: придется
зависимость: зависимости
существо: существа
сначала: сначала
сосед: соседу
начать: начали начать
требовать: требует
обожать: обожают
лоток: лоток лотка лотке лотком лотку лотки
обеспечивать: обеспечивает
древесный: древесный древесных древесные
подбирать: подбирать
аллергический: аллергическим
себя: себя
тяжелый: тяжелый
загрязненность: загрязненности
рекомендовать: рекомендуем
отзыв: отзыв
потребность: потребности
посоветовать: посоветовал
жаловаться: жаловаться
успокаивать: успокаивает
приятный: приятный приятным
купить: купите
один: один
оценка: оценки
падать: падать
иметь: имеет
нейтрализовать: нейтрализует
мочить: мочи
пример: примеры примеров
мера: мере
пользоваться: пользуются пользуется
оценить: оцените
часть: часть
последний: последнее
удерживать: удерживает
кажется: кажется
часто: часто
хождение: хождения
некоторые: некоторые некоторых
частый: частой
добавление: добавлением
тереть: три
природный: природного природный природным
процесс: процесс
отпугнуть: отпугнуть
минимизировать: минимизирует
недостаток: недостатков
кожа: кожу
уборка: уборки
делать: делают
технология: технологии
производить: производят
неловкий: неловкие
остаться: останутся
разобрать: разберем
преимущество: преимущества
качество: качестве
замена: замены
взрослый: взрослых взрослой
подойти: подойдет подойти подойдут подошел
переработка: переработки
различать: различают
домосед: домоседы
нравиться: нравится
отдельный: отдельного
добавлять: добавляемых
опыт: опыт
хвойный: хвойный хвойных
конечно: конечно
бывать: бывают
животное: животных животные
мешать: мешать
чей: чьи
забить: забьет
копать: копать
увеличивать: увеличивать
временить: времени
хотеть: хотите
подготовка: подготовка
убирать: убирать
японский: японские
нефть: нефти
стать: стали
обладать: обладает
нужно: нужно
непривычный: непривычный
интерес: интерес
нежный: нежным нежную
удержание: удержание
вызывать: вызывает
порция: порциями
это: это этом этого
труба: трубы
два: два
смена: сменой
силикагель: силикагеля силикагель
образовать: образует
стоить: стоит
кот: коты кота
его: его
неприятный: неприятные
только: только
покупать: покупайте
менять: менять меняет меняют меняйте
ветеринар: ветеринару
средний: средними
улица: улице
ароматизатор: ароматизаторов
наполнитель: наполнителя наполнителей наполнитель наполнители наполнителе
отходы: отходы отходов
или: или
ненавязчивый: ненавязчивый
возраст: возрастам
относиться: относится
идеально: идеально
чаща: чаще
точно: точно
ванный: ванной
заводчик: заводчика
быстрый: быстрее
хороший: лучше
спокойный: спокойно
много: более много
когда: когда
подхватить: подхватит
значит: значит
учитывать: учитывайте
почувствовать: почувствовать
обычный: обычный
прессование: прессования
глиняный: глиняный
упорный: упорно
засорить: засорить
болезнь: болезнь
продолжать: продолжайте
успокаиваться: успокаиваясь
список: список
первый: первый
просторный: просторные
вещество: вещество
приют: приют
состояние: состояния
заразиться: заразиться
экономичный: экономичен
след: следы
идти: идти
открыть: открытые
выполнить: выполнен
тогда: тогда
повсюду: повсюду
частное: частных
компания: компании
произвести: произведен
путем: путем
ориентироваться: ориентироваться
лапка: лапкам лапках
копание: копания
ваш: ваш вашего ваша вашей
именно: именно
так: так
старший: постарше
ставить: ставить
рекомендация: рекомендациям
четвероногий: четвероногого
ведь: ведь
возникнуть: возникнуть
больший: больше
кто: кого
песок: песком песок песке
потребоваться: потребуется
попадание: попадании
привыкнуть: привыкнет
использование: использовании
реакция: реакциям
фасовка: фасовки
всеять: всей
материал: материал материалы материалам материалов
добавка: добавок
товар: товар
минус: минусы
выбирать: выбирают выбирайте
быть: бывший был быть будут будете будет
шерсть: шерсть
тоже: тоже
неудобный: неудобен
яйцо: яйца
исходить: исходящих
достаточный: достаточное
есть: есть
бактерия: бактерии
ряд: рядом
лаванда: лаванды
шубка: шубке
мочь: может можете могут
месяц: месяца
шуршать: шуршит
сам: само сам сами
четыре: четыре
кукуруза: кукурузы кукурузу кукуруза
марка: марки
уверить: уверены
отлично: отлично
изготовить: изготовлен
вообще: вообще
угольный: угольный
кошка: кошке кошки кошек кошка кошкам
стресс: стресс
можно: можно
воздух: воздуха
отнести: отнести
основное: основное
минерал: минерала
возможный: возможен
век: века
смочь: смогут
использоваться: используется используются
производитель: производители
кошачий: кошачьих кошачьего
оказываться: оказывается
уже: уже
несомненный: несомненный
извинить: извините
характеризоваться: характеризуется
попытаться: попытаться
цвет: цвет цвета
вы: вы вам вас
магазин: магазинах
оставить: оставьте
обитатель: обитателя
необходимо: необходимо
дерево: дерева
просто: просто
обойтись: обойтись
насыпать: насыпать насыпал насыпайте
регулярный: регулярной
хлопок: хлопка
свой: своей свой
обычно: обычно
ветврач: ветврачу
нужда: нужды нужду
свое: своему своих свои
тем: тем
популярный: популярный
чтобы: чтобы
здесь: здесь
без: без
гарантировать: гарантируют
дома: дома
унитаз: унитаз
правильно: правильно
до: до
лотковый: лотков
глистогонный: глистогонные
излишний: излишняя
сложный: сложнее
нуждаться: нуждаются
особенность: особенности
представитель: представителям представителя
мелкий: мелкие
адрес: адрес
представить: представлены
другой: другие
давать: дает давать
зоомагазин: зоомагазинах
вовремя: вовремя
ее: ее
отдать: отдайте
регулярно: регулярно
застревать: застревать
пока: пока
посол: после
проживать: проживают
знать: знаете знать
комок: комки
повредить: повредят
вид: виды виде видов вид видам
влага: влагу влаги влага
закапывать: закапывать
дно: дно
плотный: плотные
горный: горных
бумажный: бумажных бумажный
попасть: попала
всегда: всегда
надежно: надежно
свойство: свойство свойствами
везде: везде
поранить: поранить
что: что чему
править: правило
закрывать: закрывал
тип: типа
за: за
указывать: указывает
поглощать: поглощает поглощать
диатомит: диатомита
котенок: котят котенка
поощрять: поощрять
совсем: совсем
моряк: моряк
спрятать: спрячут
переезд: переезда
дом: дом дому домах
ожидать: ожидают
лакомство: лакомствами
зависеть: зависит
если: если
статья: статье
микроорганизм: микроорганизмов
протекать: протекает
любой: любые любых
абсорбировать: абсорбирующую
отличаться: отличаются
пушистый: пушистого
из: из
ходить: ходить
наш: нашим
естественный: естественной
бумага: бумагу
сокровище: сокровища
удобный: удобный удобен
пылить: пылит
их: их
заказ: заказ
завести: завели
длинношерстный: длинношерстных длинношерстным
следить: следить
грязный: грязные грязный
тщательно: тщательно
квартира: квартире
различный: различные
смешивать: смешивают
закрытый: закрытого
липнуть: липнет
разный: разные разных разный
верный: верно
проглотить: проглотить
год: годах
движение: движения
защитить: защитит защитить
фракция: фракциями
жидкость: жидкости
гранула: гранул гранулы гранулами
обратиться: обратиться
справлять: справлять
упаковка: упаковку
приходиться: приходилось
берет: берете
малыш: малыша малышей
глина: глину глина глины
безопасность: безопасности
решить: решили
прекрасно: прекрасно
который: которые который которое которым
аромат: аромат ароматом
вывод: выводы
поэтому: поэтому
легкий: легкий
крупный: крупные крупных крупными крупным
например: например
подобрать: подберите подобранного подобрать
ли: ли
привести: приведем
пища: пищи
уничтожать: уничтожающие
довольствоваться: довольствоваться
выбрать: выберите выбранного выбрать
рассказать: расскажем
колтун: колтуны
хорошо: хорошо
случай: случае
жизнедеятельность: жизнедеятельности
небезопасный: небезопасно
такой: таким такой
плюс: плюсы плюсам плюс плюсов
правильный: правильного
жить: живут
несколько: несколько
питомец: питомца питомцам
похрустывание: похрустывание
начало: начала
место: места
безопасно: безопасно
очистки: очистки
предпочитать: предпочитают
изготовление: изготовления
никакой: никакие
натуральный: натуральные натуральное натуральных
благодаря: благодаря
включать: включает
бентонит: бентонит бентонита
мы: мы
крайне: крайне
ввиду: ввиду
перечислить: перечислим
на: на
приучение: приучения
состав: составу состав
совершенно: совершенно
тот: то те том тот
роскошный: роскошной
выбор: выбор выборе выбору
использовать: использовать использованные используют использовали
не: не
эда: эд
каждый: каждого каждом каждые
указать: укажите
частить: части
кукурузный: кукурузный кукурузные
содержать: содержат
любитель: любителей
поздний: позднее
маленький: мал мало
но: но
разносить: разносить
почта: почту
привычный: привычного
разрешать: разрешают разрешать
вызвать: вызвать
история: истории
поход: походов походах походами
идеальный: идеального
появление: появления
длить: для
обрабатывать: обрабатывают
количество: количество
туалет: туалетом туалет туалета туалете
прилипать: прилипают прилипает
об: об
личинка: личинки
навредить: навредить
опилка: опилок опилки
нет: нет
название: название названия
нейтрализация: нейтрализацию
он: он него ему
семья: семьи
копаться: копаться
предлагать: предлагают
даже: даже
от: от
минусовый: минусов
избегать: избегать
попробовать: попробовать
блоха: блох
первое: первое
как: как
все: всего всему все всем всех
видно: видно
низкий: ниже
уголь: уголь
глист: глистами глистов глисты
помогать: помогает
индикатор: индикаторы
по: по
отсутствовать: отсутствует
выпускать: выпуская
поинтересоваться: поинтересуйтесь
впитывать: впитывающий впитывала впитывает впитывают впитывающих
склонный: склонна
немой: нем
риск: риск
очень: очень
порода: пород породам
способ: способ
высокий: высокую
какой: каким какой какие
забывать: забывайте
наличие: наличии
второе: второго
проверить: проверить
цепляться: цепляются
переть: при
второй: второй
