долгий: долгого дольше
доставка: доставку
собаковод: собаководов
таблетка: таблетки таблеток таблетка таблетку таблетками
забрать: забрать
прогулка: прогулках
спасибо: спасибо
рот: рот
любить: любит любим любимому
ребенок: детьми детей
лапа: лапы
эффективный: эффективен эффективное эффективный
менее: менее
под: под
множество: множество
разламывать: разламывать
а: а
в: в
заболевание: заболевания
содержание: содержание
лес: лесам лесу
и: и
охотничий: охотничьей
к: к
плотно: плотно
о: о
продолжаться: продолжается
насколько: насколько
с: с
она: она
средство: средство средства
у: у
глотание: глотание
течение: течение
шпиц: шпиц шпица
запах: запаха
клещ: клещами клещ клещам клещей клещи
сезон: сезон сезону
знакомый: знакомых знакомого
владелец: владельцы владельцев
собрать: собраны
я: мне меня я
природа: природе
укол: уколом
конкретный: конкретное
миф: мифа мифы
подделка: подделок
теперь: теперь
необходимый: необходимы
поместить: поместить
опытный: опытных
искупаться: искупаться
время: время
весной: весной
единственный: единственное
посоветоваться: посоветуйтесь
погладить: погладьте
горло: горлу
простота: простоты простота
проблема: проблем
купание: купании
также: также
появиться: появилась появилось появится
предосторожность: предосторожности
город: городом
получение: получения
час: часа
легко: легко
прием: приема
удобно: удобно
водоем: водоеме
написать: напишем
дороговатый: дороговато
вред: вред
отсутствие: отсутствие
подбирать: подбирайте
судить: судить
требоваться: требуется
аллергический: аллергических
последствие: последствий последствия
рекомендоваться: рекомендуется
читать: читал
рекомендовать: рекомендую рекомендуют рекомендует рекомендуем
отзыв: отзывов отзыв
действенный: действенен
съедать: съедает съедают
один: одним одного один
оценка: оценки
иметь: имеет
снизить: снизит
мера: меры
пользоваться: пользуемся пользовались пользоваться
оценить: оцените
приобретаться: приобретается
дорогой: дорого
мой: мою
кажется: кажется
часто: часто
некоторые: некоторых
помочь: поможет
изнутри: изнутри
тереть: три
природный: природном
аппарат: аппарат
недостаток: недостатков
опасаться: опасаются
негативный: негативного негативные негативном
разобрать: разобрать
преимущество: преимущества
через: через
подряд: подряд
результат: результатом
особенно: особенно
большой: велик большой
довольный: довольны
опасность: опасность
животное: животными
гигантский: гигантских
обманывать: обманывает
временить: времени
эффективность: эффективность
гарантированный: гарантированно
закупаться: закупаюсь
стать: стали
работать: работает работают
условный: условное
отличный: отличный
актуально: актуально
доберман: добермана
приобретать: приобретать
переносить: переносит
это: это этого этом
гулять: гулять гуляли гуляем
джек: джек
вкус: вкус
два: два
ошейник: ошейниками
удобство: удобство
вполне: вполне
сертифицировать: сертифицирована
его: его
эффект: эффектов
только: только
покупать: покупаем покупали
тошнить: тошнит
ветеринар: ветеринары ветеринаром ветеринаров
менять: менять
капля: каплями капли
овчарка: овчарка
средний: средний
или: или
целый: целых
отличие: отличии
относиться: относятся
впитываться: впитываются
точно: точно
необработанный: необработанными
защита: защиты защитой
воздействие: воздействия воздействии
считать: считать
минимум: минимум
хороший: хорошее лучший
спокойный: спокойны спокойно
объятие: объятиях
много: много
наносить: наносимые
переплачивать: переплачиваю
наноситься: наносится
когда: когда
вкусный: вкусное
ждать: жду
затем: затем
действие: действия действие действием
продолжать: продолжать
первый: первый
среагировать: среагировали
осень: осенью
значение: значение
увы: увы
стимулировать: стимулируя
размер: размеру
ваш: вашей ваш
так: так
главное: главное
там: там
рекомендация: рекомендации
ведь: ведь
мыть: моет
срок: срока
кто: кто
пользователь: пользователи
использование: использования использовании
реакция: реакций
неделя: неделях недель
товар: товар
минус: минусам
выбирать: выбирайте выбирать
быть: будем
печень: печени печень
шерсть: шерстью шерсть
снижаться: снижается
отмечать: отмечают
тоже: тоже
дозировка: дозировку дозировки
есть: ест едят
лечиться: лечились
ряд: ряд
приобретение: приобретением
месяц: месяцев месяца месяц
перерыв: перерывом перерыве
попадать: попадает
мочь: могу могут
этот: эти этот
сам: самое сама
борьба: борьбы
четыре: четыре
уверить: уверена
пироплазмоз: пироплазмоза
отметить: отметили
кошка: кошек
померанский: померанского
можно: можно
дать: данный дать
почтить: почти
возможный: возможного возможны
действовать: действовать
немецкий: немецкий немецкая
производитель: производителя производитель
во: во
третий: третий
вес: весу
уже: уже
извинить: извините
раз: раза раз
магазин: магазину магазинах магазине
оставить: оставьте
еле: еле
обойтись: обошлось
просто: просто
побочный: побочных
свое: своего
тем: тем
густой: густой
плавать: плавать
контактировать: контактирует
дикий: дикими
цена: цена
без: без
гарантировать: гарантирует
карликовый: карликовых
перед: перед
сайт: сайте
шерстить: шерсти
поле: полям
правильно: правильно
до: до
полезный: полезное
наблюдать: наблюдали
адрес: адрес
другой: другого другими
представить: представленных
весить: весь
давать: давать давали
собственный: собственно
определенно: определенно
посол: после
развенчивать: развенчиваем
период: периодом
защищать: защищает
число: числе
знать: знали
порекомендовать: порекомендовать
неправильно: неправильно
же: же
попасть: попасть
всегда: всегда
оба: оба
везде: везде
степь: степях
что: что
повезти: повезло
за: за
домашние: домашних
удовольствие: удовольствием
паразит: паразита
вредоносный: вредоносном
ожидать: ожидают
брать: брали брать
свободный: свободном
лакомство: лакомство
если: если
укусить: укусил
из: из
ограничение: ограничений
наш: нашей нашем нашему наших
ходить: ходит
обстановка: обстановка
ветеринарный: ветеринарных
кусать: кусал
получить: получу
многие: многие
контакт: контакте
язык: языка
заказ: заказ
терьер: терьер
аппетитный: аппетитный
сделать: сделать
заметить: замечено
здоровье: здоровья
год: года лет год
двор: дворе
пес: пёс
спасти: спасли
собака: собак собаку собаке собаками собаки собака
продукция: продукция
мая: мае
который: которые которая который которое которого
аромат: аромат
вывод: вывод
поэтому: поэтому
лететь: лечу
длительность: длительность
холка: холку
например: например
любимец: любимцев
подобрать: подобранной
выбрать: выбрать
хорошо: хорошо
акция: акций акции
сразу: сразу
плюс: плюс плюсам плюсы
отваливаться: отваливались
подтверждение: подтверждений
питомец: питомца питомцев питомец питомцами питомцу
начало: начало начала начал
регион: регионе
рука: руки
никакой: никаких
корень: корень
погулять: погулять
мы: нас мы
на: на
тот: том
использовать: используют использовали
не: не
выбор: выбор
ни: ни
сложно: сложно
указать: укажите
ужасный: ужасная
любитель: любителям любителей
но: но
маленький: маленьких меньше
поздний: позже
почта: почту
три: трех
длить: для
непосредственно: непосредственно
об: об
обратить: обратите
влияние: влиянии
нет: нет
обновление: обновление
дождь: дождь
реальный: реальных реальная
семья: семье
даже: даже
от: от
форум: форумах
аналогичный: аналогичный
длинный: длинной
попробовать: попробуйте
блоха: блохами блох
как: как
внимание: внимание
все: все всем
принимать: принимаем
препарат: препарат препарата препараты препаратов
помогать: помогало
по: по
безопасный: безопасен
огромный: огромный
стоимость: стоимости
подлинность: подлинность
деревенский: деревенскими
риск: риск
выгул: выгуле
видеть: видели
очень: очень
порода: порода пород
способ: способ
наличие: наличии
проверить: проверенных
переть: при
