эфирный: эфирными
день: дней
таблетка: таблеток таблетки
еще: еще
мама: мамы
заключаться: заключается
позаботиться: позаботиться
подцепить: подцепить
эффективный: эффективны
менее: менее
важный: важно
под: под
множество: множество
пол: полы
помощь: помощью
жертва: жертву
а: а
дополнительно: дополнительно
в: в
помещение: помещения
содержание: содержание
выводить: выводить
и: и
живой: живым
к: к
о: о
подходить: подходящего подходят подходящий подходит
вероятность: вероятностью
с: с
она: нее
переносчик: переносчиками
исследование: исследования
средство: средств средствах средство средства
у: у
новорожденная: новорожденных
передаваться: передающимся
снаружи: снаружи
применять: применять
определить: определите определить
течение: течение
шампунь: шампуни
клещ: клещи клещами клещей клеща
они: них они ними
наступление: наступлением
владелец: владельцы
оно: оно
ограниченность: ограниченность
кормить: кормящих кормящим кормящей кормящие кормящую
время: время
проблема: проблемой
главный: главный
купание: купания
также: также
обитать: обитают
появиться: появится
получение: получения
следовать: следует
написать: напишем
трава: траве
зависимость: зависимости
вред: вред
требовать: требуют
победить: победить
дискомфорт: дискомфорт
аллергический: аллергической
однако: однако
удалить: удалить
последствие: последствиям
предназначить: предназначенные
рекомендоваться: рекомендуется
система: системы
тяжелый: тяжелыми
случайно: случайно
рекомендовать: рекомендуем
крепкий: крепкое крепкий
отзыв: отзыв
нападение: нападению
постепенно: постепенно
купить: купленными
один: одного одно
оценка: оценки
детишки: детишек
посетить: посетите
мера: мерах
оценить: оцените
лишь: лишь
заметный: заметны
некоторые: некоторые
помочь: помогут
изнутри: изнутри
укус: укусы укусе укусов
инфекция: инфекции инфекциям инфекций инфекциями
плюсовой: плюсовой
метод: метод
процесс: процесс
кожа: кожей кожу кожи
уборка: уборки
ошибочно: ошибочно
среди: среди
качество: качестве
взрослый: взрослых
столько: столько
врач: врач врача
результат: результатов
доставлять: доставляют
рынок: рынке
назначить: назначить назначит
полок: полки
далее: далее
должен: должно
опасность: опасность
выделяться: выделяются
являться: являются
зонт: зонта
получать: получают
никогда: никогда
животное: животных животного
временить: времени
инсектицид: инсектицидом инсектицидами инсектициды инсектицида
угроза: угрозу
нужно: нужно
лабораторный: лабораторные
группа: группы
обработка: обработки обработку обработке
это: это этом
поддерживать: поддерживать
вкус: вкус
обнаружить: обнаружены
молодая: молодым
чесоточный: чесоточным чесоточные чесоточными
его: его
неприятный: неприятном
только: только
жизнь: жизни
капля: капли
нельзя: нельзя
покров: покровов
заразный: заразны
заражение: заражения
или: или
особенный: особенный
вынашивание: вынашивание
возраст: возраст возраста
сожаление: сожалению
чаща: чаще
защита: защиты
считать: считают
уход: ухода
много: много
слизать: слижут
осложнять: осложняет
когда: когда
профилактика: профилактику профилактики профилактике
слабеть: слабеет
учитывать: учитывать
атаковать: атакуют
действие: действием
болезнь: болезнях
вещество: вещество
масса: массу
состояние: состояние
всасываться: всасывается
слабый: слабого
мягкий: мягче мягким
необратимый: необратимым
именно: именно
против: против
ваш: вашей ваш
так: так
старший: старше
иногда: иногда
четвероногий: четвероногого
ведь: ведь
мыть: мыть
основание: основании
кто: кто
активный: активное
использование: использовании
реакция: реакцией
неделя: недель
товар: товар
выбирать: выбирая
быть: быть
представлять: представляют
кровососущий: кровососущих кровососущие кровососущими
защититься: защититься
мочь: может могут
активизироваться: активизируются
сам: сами
борьба: борьбы борьба
потомство: потомства потомству
друг: друга
сохранить: сохранить
иммунитет: иммунитета иммунитет
смыть: смыть
можно: можно
действовать: действуют
использоваться: используются
производитель: производители
во: во
вес: вес веса
уже: уже
извинить: извините
оставить: оставьте
проводить: проводить проводит проводят
необходимо: необходимо
специалист: специалистом
просто: просто
регулярный: регулярной
лесной: лесные
порок: пороки
лечить: лечить
щенок: щенков щенки щенка щенят щенята
свой: свою
ветврач: ветврач
свое: свои
убедиться: убедитесь
тем: тем
чтобы: чтобы
следовательно: следовательно
перед: перед
жучка: жучки
до: до
рождение: рождения
особенность: особенности
выступать: выступают
мелкий: мелкие
адрес: адрес
другой: других другие
почетный: почетный
клетка: клетку
весить: весит
ее: ее
ослабить: ослабить ослабленный ослаблен
перепутать: перепутать
пожилой: пожилых пожилого пожилую
проконсультироваться: проконсультируйтесь
регулярно: регулярно
побрызгать: побрызгать
посол: после
профилактический: профилактических
период: период
защищать: защищающего защищает
параметр: параметры
беременность: беременности
производиться: производится
вид: виды
бороться: бороться
незаметно: незаметно
что: что чем
масло: маслами
фрукт: фруктами
подверженный: подвержена подвержены
зуд: зудом зуда
будущий: будущей
домашние: домашних
паразит: паразитов паразитами паразиты
указывать: указывают
совсем: совсем
форма: формы формах
дом: дом
ожидать: ожидают
поверхность: поверхности
разделить: разделены
роды: родов
зависеть: зависит
несформированный: несформированного
существовать: существуют
если: если
размножаться: размножаются
пушистый: пушистых
организм: организм организмам организма
из: из
возрастной: возрастных
ветеринарный: ветеринарным ветеринарный ветеринарного
серьезный: серьезный серьезные серьезно
кусать: кусают
их: их
получить: получить полученных
многие: многих многие
насекомое: насекомые насекомых
компонент: компонент компоненты
перестраиваться: перестраиваются
заказ: заказ
покупка: покупке
фактор: факторы факторов
тщательно: тщательно
различный: различных
здоровье: здоровье здоровья
тело: теле телу
обращать: обращать
влажный: влажной влажных
разный: разные
мучить: мучают
проглотить: проглотила
год: лет
кг: кг
распространить: распространенной
защитить: защитить
пес: пес
собака: собак собаки собака собаку собакам
кустарник: кустарниках
характерный: характерны
лечение: лечения
мать: матери
малыш: малышей малыша малыш малышам
крохотный: крохотных
беременная: беременных беременным беременные беременную беременной
который: который которые
вывод: выводы
поэтому: поэтому
выведение: выведения
холка: холку
любимец: любимцам любимца любимцев
следующий: следующие
ли: ли
вещь: вещами
привести: приведет
подбора: подбора
повышенный: повышенную
жизнедеятельность: жизнедеятельности
температура: температуры
такой: такой
вместе: вместе
жить: живут
тенистый: тенистых
несколько: нескольких
питомец: питомцам питомца питомец питомцев
начало: началом
место: местах
кожный: кожных
мы: мы
ввиду: ввиду
на: на
состав: составе составы
тот: то
не: не
использовать: используемых использовать
выбор: выбором выборе
самостоятельно: самостоятельно
наиболее: наиболее
каждый: каждой
указать: укажите
кровь: кровь
но: но
маленький: меньше
почта: почту
нанесение: нанесения
щадить: щадящих
выпускаться: выпускаются
длить: для
противостоять: противостоять
обрабатывать: обрабатывать обрабатывают
начинать: начинают
об: об
принести: принести
обратить: обратите
навредить: навредят
орган: органов
он: него он
развитие: развития
даже: даже
от: от
молодой: молодого
попробовать: попробовал
блоха: блохи блохами блох
причинять: причиняют
первое: первые
как: как
внимание: внимание
все: всех все
препарат: препаратов препараты препарат препарата
привносить: привносит
противопоказанный: противопоказан
передавать: передавать передает передаваемыми
осмотреть: осмотрит
выпуск: выпуска
безопасный: безопасны безопасное безопасные
самка: самки
опасный: опасны
шерстка: шерстке
одежда: одеждой
подбираться: подбирается
проникать: проникая
очень: очень
порода: порода породы породу
способ: способы способ
высокий: высокой высокое
забывать: забывать забывайте
наличие: наличии
второе: вторые
продукт: продукты
переть: при
источник: источник
