дада: дада
олень: оленя
новый: новый
найти: найти найдете
лампа: лампу
невероятный: невероятные
прогулка: прогулке
любить: любимым любимой
пребывать: пребывает
снимать: снимайте
заключаться: заключается
успех: успеха
со: со
центр: центром
касаться: касается
важный: важно
наряд: нарядах
под: под
полный: полную
предложить: предложите
запоминаться: запоминающиеся
исполнение: исполнении
человек: людьми человек
а: а
в: в
композиция: композиции композицию
помещение: помещении помещение
трудный: трудно
немного: немного
тестовый: тестовых
содержание: содержание
и: и
к: к
добиться: добиться
о: о
коллекция: коллекции
с: с
она: она
они: им они ним
дополнительный: дополнительный
собрать: соберут
я: я
фототехник: фототехнику
уж: уж
рожок: рожками рожек
эксперимент: эксперименты
необходимый: необходимую
тонкий: тонко
поместить: поместите
бояться: бойтесь
планировать: планируйте
небольшой: небольшого
время: время
быстро: быстро
забыть: забудьте
создавать: создает
социальный: социальных
непропорциональный: непропорциональным
поощрить: поощрить
погладить: погладьте
найтись: найдется
телепередача: телепередачи
пробовать: пробуйте
проблема: проблем
главный: главный
также: также
член: член членов
дневной: дневном
появиться: появится
получение: получения
фотография: фотографии фотографий
прием: прием
написать: напишем
котик: котик
находиться: находятся
кадровый: кадров
изменение: изменениям
сидеть: сидеть
света: свете свет света
фотографировать: фотографируйте фотографировать
фотоснимок: фотоснимки
требовать: требует
мороз: мороза
задумка: задумка
хлопнуть: хлопнуть
хотя: хотя
заслужить: заслужил
освещение: освещения освещение
порядок: порядок
себя: себя себе собой
приближаться: приближается приближающемся
далекий: дальше
рекомендовать: рекомендуем
отзыв: отзыв
опять: опять
фотосъемка: фотосъемки
приятный: приятные
ладоши: ладоши
один: один
оценка: оценки
родные: родными
иметь: иметь
совет: советы совет
видео: видео
оценить: оцените
смотреться: смотреться
свобода: свободу
сторона: сторону
кстати: кстати
минута: минут
выпустить: выпустили
момент: момент
надеть: надеть
помочь: помочь
заслуживать: заслуживает
заинтересоваться: заинтересовавшись
процесс: процесс
говорить: говорить
делать: делайте
самочувствие: самочувствия
хомячок: хомячка
секрет: секрет
меню: меню
вечер: вечера
испуганный: испуганный
команда: команды команду
должен: должны должен
праздничный: праздничное праздничной праздничных
конечно: конечно
бывать: бывает
новогодний: новогодний новогоднем новогоднего
размытый: размытее
хотеть: хотите
солнце: солнца
подготовка: подготовкой
решать: решает
устроить: устроить
достаточно: достаточно
стать: станет
работать: работает
тематика: тематике
навести: наведите
отличный: отличном отличных
провести: проведут проведите
это: это этого этом
шапочка: шапочки
встать: встал
удобство: удобства
дрессировка: дрессировка
вряд: вряд
привлекать: привлекаем
настроить: настрой
ракурс: ракурс
его: его
удачный: удачными
красивый: красивым
сфотографироваться: сфотографируйтесь
сфотографировать: сфотографировать
менять: меняйте
привлечь: привлеките
держать: держать
или: или
звук: звук
стеклянный: стеклянным
чаща: чаще
колпак: колпака
почему: почему
хороший: лучшему хорошем лучше хороших хороший
спокойный: спокойным
много: много
елка: елкой
когда: когда
играть: играет
тематический: тематических тематические
обычный: обычного
ждать: ждать
жилье: жилья
позабавиться: позабавиться
забавный: забавные забавный
действие: действий
кадр: кадре кадр
настроение: настроение настроении
желание: желаний
состояние: состояние состоянии
дед: деда
ошибка: ошибку
приобрести: приобретите
выполнить: выполненной
тогда: тогда
мягкий: мягкий
поскольку: поскольку
компания: компанию
уютный: уютную
песнь: песни
лапка: лапкой лапки
размер: размера
мыслить: мысли
против: против
ваш: вашего вашей ваш
так: так
профессиональный: профессиональную профессиональные
лайковый: лайков
там: там
иногда: иногда
четвероногий: четвероногий четвероногого четвероногими четвероногой
фантазия: фантазии
ведь: ведь
возникнуть: возникнет
постараться: постарайтесь
самый: самый самых самые
обзавестись: обзаведитесь
товар: товар
выбирать: выбираем
быть: быть будет было был была будут будете
необязательно: необязательно
устать: устал
гирлянда: гирлянды гирляндами
хлопоты: хлопоты
камера: камера
аккуратный: аккуратно
тоже: тоже
расположение: расположении расположение
есть: есть
экспериментировать: экспериментируйте экспериментировать
лишний: лишнее
атмосфера: атмосферу
ободок: ободки
перерыв: перерывы
мочь: может
светить: светит
этот: этот
сам: самого
убранство: убранство
просидеть: просидеть
плохо: плохо
тута: тут
кошка: кошки кошками
бы: бы
известный: известной
потолок: потолок
настраивать: настраивает
дать: дайте
темперамент: темперамента
долгожданный: долгожданный
смочь: сможет
извинить: извините
вы: вы вам
оставить: оставьте
ролик: роликов
отвлечь: отвлечь
эмоциональный: эмоциональное
чудо: чуде
словом: словом
чувствовать: чувствуют чувствуете
переборщить: переборщить
простой: проще прост
смотреть: смотрел
порой: порой
убедиться: убедитесь
тем: тем
чтобы: чтобы
получиться: получится
здесь: здесь
настольный: настольную
необходимость: необходимости
дома: дома
грустно: грустно
бер: беру
сложный: сложны
адрес: адрес
представить: представленных
работа: работу работа
оставаться: оставаться
ее: ее
сеть: сетях
отдать: отдать
интерьер: интерьер интерьере
посол: после
праздник: праздник
неожиданно: неожиданно
украшение: украшение
знать: знает
автор: авторов
неправильно: неправильно
вид: виде
же: же
видеокамера: видеокамеру
волшебный: волшебный волшебное
всегда: всегда
поднять: поднимут
ярко: ярко
что: что чем
за: за
предмет: предметов
домашние: домашних
удовольствие: удовольствием
домашний: домашнего
продумать: продумайте
ожидать: ожидают
залог: залог
лакомство: лакомством
зависеть: зависит
костюм: костюм костюмы
получаться: получались
если: если
хозяин: хозяина
любой: любая
из: из
поза: позу позе позы
елочка: елочки
многий: многое
нарядить: нарядить
настоящий: настоящей
многие: многие
получить: получите
близкие: близкими
фон: фон
направить: направьте
заказ: заказ
уставать: устают
похвалить: похвалите
издать: издать
шарик: шариком
зимой: зимой
план: плана
игрушка: игрушкой игрушки
объяснить: объяснишь
угостить: угостите
сделать: сделайте сделать сделанные
связанный: связанные
различный: различные
заметить: заметили
гость: гостей
вспышка: вспышкой
здоровый: здоров
год: год
движение: движении
распространить: распространенную
собака: собаки собака собаками
строчок: строчки
стараться: старайтесь
который: которое который которого которые
поэтому: поэтому
убрать: уберите
мерцание: мерцание
награда: награды
расстояние: расстоянием
снимка: снимки
например: например
любимец: любимца любимцах любимец любимцев любимцу
заинтересовать: заинтересовать
ли: ли
привести: приведет
выбрать: выбрать выбранный
присылать: присылаемых
заснуть: заснула
пропеть: пропели
хорошо: хорошо
помощник: помощник помощником
создать: создать
такой: такие
вместе: вместе
фотокамера: фотокамеры
правильный: правильное
нужный: нужную нужной нужного нужен
возвышение: возвышение
несколько: несколько
питомец: питомец питомца
съемка: съемки съемках
неожиданный: неожиданный неожиданные
оптимальный: оптимальное
дух: духа
рука: рукой
собираться: собираетесь
заветный: заветных
погулять: погулять
отдых: отдых
мы: нас мы
приглашение: приглашение
на: на
тот: то тому
глаз: глаз
не: не
использовать: использовать используйте
задний: заднего задние
организация: организации
указать: укажите
смартфон: смартфона смартфон
но: но
почта: почту
статичный: статичную
длить: для
совершить: совершить
звезда: звездой
модель: модели
уровень: уровне
составить: составит
пересматривать: пересматривать
поиграть: поиграйте
он: он ему него
семья: семьи
предлагать: предлагать
даже: даже
от: от
усталость: усталость
попробовать: попробуйте
помять: помните
как: как
внимание: внимание
испугать: испугает
все: все всем
утомительный: утомительным
условие: условиях
помогать: помогают
осветить: осветит
снимок: снимков
оснастить: оснащены
по: по
принять: принять принял
продумывание: продумывание
скорый: скорее
способ: способ
какой: каким
наличие: наличии
аксессуар: аксессуар аксессуары
активно: активно
переть: при
источник: источник
