состоять: состоящие
покрыть: покрыто
формула: формула
раздражение: раздражения
эфирный: эфирных
день: дней дня
дискомфортный: дискомфортные
таблетка: таблетками таблетку таблеток таблетки
служить: служат
прогулка: прогулках
еще: еще
подцепить: подцепить
эффективный: эффективны эффективные эффективнее
со: со
важный: важно
под: под
эпидемия: эпидемия
разразиться: разразилась
множество: множество
встретить: встретить
жертва: жертвы
аллергия: аллергии
человек: человека
вода: водой
а: а
в: в
заболевание: заболеваний заболевания заболеванием
помещение: помещениях помещений
содержание: содержание
лес: лес
и: и
живой: живое
к: к
о: о
подходить: подходит подходят подходящее
она: ней нее
переносчик: переносчиками
с: с
хитиновый: хитиновым
средство: средств средства средством средство
у: у
применять: применять
определить: определенный определенное определенного
шампунь: шампуней шампуни шампуня шампунь
течение: течение
запах: запах
область: область
они: они них ним
клещ: клещей
дополнительный: дополнительной
панцирь: панцирем
унести: унесла
гигиена: гигиены
необходимый: необходимые
раздвинуть: раздвиньте
кормить: кормящих
небольшой: небольшое небольшой небольшим
имаго: имаго
время: время
быстро: быстро
сегодняшний: сегодняшний
австрия: австрия
миллиметр: мм
выходить: выходит
сильный: сильный
составлять: составляет
посещение: посещении
иной: иного иное
также: также
корма: корма
появиться: появится
получение: получения
кровоток: кровоток
следовать: следовать следует
прием: приеме
написать: напишем
шанс: шансов
трава: траве
лактация: лактации лактация
темнобурый: темнобурый
снова: снова
существо: существо
зависимость: зависимости
вторичный: вторичной
вред: вред
наконец: наконец
воздействовать: воздействующие
чреватый: чревато
уничтожение: уничтожение
мороз: морозы
гребень: гребни
подвергаться: подвергаются
однако: однако
слой: слой
себя: собой себя
часы: часов
читать: читайте
рекомендовать: рекомендуем
отзыв: отзыв
волноваться: волноваться
приятный: приятный
заражаться: заражаются
оценка: оценки
оттенок: оттенок
иметь: имеет имеют
полностью: полностью
выждать: выждать
длина: длиной длину
мера: меры мере
пользоваться: пользоваться
оценить: оцените
чесаться: чешется
лишь: лишь
практический: практически
эктопаразит: эктопаразиты эктопаразита эктопаразитов
сумка: сумках
кстати: кстати
минута: минут
инструкция: инструкцию инструкции
часто: часто
момент: момент
лето: летом
надеть: надеть
некоторые: некоторые
помочь: помочь помогут поможет
укус: укусы укуса
обувь: обуви
инфекция: инфекции
сша: сша
фиксация: фиксации
желательно: желательно
подвести: подведем
основа: основе
предполагаться: предполагается
расчесать: расчесать
способный: способна способны способные
кожа: кожу
делать: делать
негативный: негативно
обработать: обработать
среди: среди
повторить: повторить
пингвин: пингвинов
качество: качестве
конечность: конечности
через: через
воспользоваться: воспользоваться
взрослый: взрослого взрослая взрослую взрослых
удивительно: удивительно
подойти: подойдет
врач: врачу врачом
зажим: зажимы
куколка: куколка куколки
климат: климате
особенно: особенно
выглядеть: выглядит
встречаться: встречаются
назначить: назначенную
должен: должно
являться: являются является
бывать: бывает бывают
конечно: конечно
заразить: зараженными заразить
публичный: публичных
выздоравливать: выздоравливающим
животное: животным животного животные животных
погрызть: погрызть
длиться: длится
весомый: весом
инсектицид: инсектициды
повторный: повторного
достаточно: достаточно
стать: стала стать станет
нужно: нужно
обладать: обладают
работать: работают
нестерпимый: нестерпимым
инфекционный: инфекционные
возможно: возможно
крысиный: крысиные
питаться: питающиеся
вызывать: вызывают вызывает
провести: провести
это: это этом
холодное: холодном
обработка: обработке обработки
большинство: большинство
ограничивать: ограничивать
вкус: вкус
ошейник: ошейник ошейники
два: два
обнаружить: обнаружили
молодая: молодые
вполне: вполне
стоить: стоит
его: его
эффект: эффектом
анемия: анемии
жизнь: жизнь жизней жизни
только: только
сантиметр: см
капля: каплями капли
средний: среднем
нельзя: нельзя
пипетка: пипетка
улица: улице улицу
заражение: заражения заражение
или: или
отличие: отличие
возраст: возрастов возрасте возраста возрасту
капнуть: капните
бубонный: бубонной
инсектицидный: инсектицидный инсектицидными инсектицидные
допустить: допустить
особь: особь
необработанный: необработанными
причем: причем
теплый: теплых
защита: защиты защита
успевать: успевает
особый: особей
спот: спот
быстрый: быстрое
хороший: лучше
много: более
регулировать: регулировать
внушительный: внушительными
наноситься: наносятся
крупинка: крупинок крупинки
когда: когда
вошь: вшей
профилактика: профилактикой
употребить: употребил
затем: затем
губительный: губительно
чувствительность: чувствительность
говядина: говядины
разрешить: разрешенные разрешен разрешены
вещество: вещество вещества
состояние: состоянии
заразиться: заразиться
итог: итоги
приобрести: приобрели
всасываться: всасывается
происхождение: происхождения
подвал: подвалах
германий: германия
наблюдаться: наблюдается
поскольку: поскольку
примерный: примерно
размер: размерами размеру
присоединение: присоединением
высота: высоту
наблюдение: наблюдением
именно: именно
ваш: вашему вашей ваш
против: против
так: так
главное: главное
присутствовать: присутствует
четвероногий: четвероногого четвероногими четвероногий четвероногих четвероногие
ведь: ведь
больший: больших больше
где: где
активный: активны
дальнейший: дальнейшем
предпочтение: предпочтение
расчесывать: расчесывая
англия: англии
неделя: недель
самый: самые самыми
товар: товар
быть: быть было были
шерсть: шерсть шерстью
вывести: вывести
тоже: тоже
частота: частота
яйцо: яйцо яйца яиц
дозировка: дозировку
темный: темных
назначение: назначениям
есть: есть
представлять: представляют
внимательно: внимательно
ряд: ряда
покраснение: покраснений
франция: франция
мочь: могут может можем
месяц: месяц месяцев месяца
попадать: попадает
этот: эти этой
объем: объем
убивать: убивают
широта: широтах
когтистый: когтистые
основной: основных
палочка: палочка
смыть: смыть
гельминт: гельминтов
кошка: кошек
осторожность: осторожностью
бы: бы
известный: известными
можно: можно
применение: применению применением применения применении
дать: данный данная дать
болезненный: болезненны
развести: развести
действовать: действующее действующие действуют
подстилка: подстилок
производитель: производителям производитель производителя производители
во: во
наступать: наступает
известно: известно
уже: уже
извинить: извините
больной: больным
соблюдаться: соблюдаются
прыгать: прыгать
раз: раз
того: того
магазин: магазинов
вы: вы
оставить: оставьте
проводить: проводить
необходимо: необходимо
отложить: отложить
специалист: специалиста
соблюдать: соблюдать соблюдайте
луговой: луговой
чувствовать: чувствуют
регулярный: регулярной регулярные
россия: россия
тест: тест
смываться: смываются
личной: личных
порой: порой
щенок: щенков
обычно: обычно
свой: свою
парк: парк
устранять: устраняют
тем: тем
популярный: популярные
чтобы: чтобы
противопаразитарный: противопаразитарной
контактировать: контактировать
нематода: нематод
без: без
перед: перед
необходимость: необходимости
предупреждать: предупреждают
шерстить: шерсти
до: до
погибать: погибает
помнить: помнить
положить: положенное
мытье: мытьем
адрес: адрес
другой: другое других другим другие
запечься: запекшейся
отпугивать: отпугивают отпугивает
оставаться: остаются оставаться
неподвижный: неподвижными
ее: ее
чумная: чумная
сочетание: сочетаниям
психологический: психологическом
посол: после
профилактический: профилактические
червячок: червячков
период: период периоде
защищать: защищают защищает
число: числе
причина: причиной
беременность: беременности беременность
вид: видах вид видов видами виды
же: же
кроме: кроме
грызун: грызунах
всегда: всегда
купать: купать
что: что чем
масло: масла масел
тушеный: тушеной
править: правила
отдавать: отдавать
зуд: зуд зуда
за: за
домашние: домашних
паразит: паразита паразитов паразит
форма: форма
дом: дом доме
уменьшать: уменьшает
ожидать: ожидают
точечный: точечно
изготавливаться: изготавливаются
применяться: применяются применяется
процедура: процедуру
статья: статье
если: если
существовать: существует
любой: любое
отличаться: отличается
из: из
ограничение: ограничений
бездомный: бездомными
перемещаться: перемещаться
наш: наших
ветеринарный: ветеринарных ветеринарному ветеринарным
казаться: казалось
серьезный: серьезный
удобный: удобна удобны
их: их
бактериальный: бактериальной
токсин: токсинов
многие: многих
насекомое: насекомые насекомое насекомых
контакт: контакте контакты контакта
компонент: компоненты
напоминать: напоминают
заказ: заказ
нидерланды: нидерланды
зимой: зимой
чердак: чердаках
настолько: настолько
около: около
салон: салонов
тщательно: тщательно
заметить: заметить
здоровье: здоровью
тело: тело тела
словения: словения
смешивать: смешивать
нанести: нанести
влажный: влажных влажного
вспышка: вспышки
белков: белков
желтоватый: желтоватых
невооруженный: невооруженным
год: года
кг: кг
пакет: пакетах
обратиться: обратиться обратитесь
собака: собак собаки собаке собаку собака
клиника: клиник
упаковка: упаковке
кишечный: кишечных
малыш: малышей
передвигаться: передвигаться
беременная: беременных
прекрасно: прекрасно
который: которые который которых которой
постоянный: постоянного
аромат: аромат
поэтому: поэтому
легкий: легче легкой
холка: холку холки
чума: чумы
участок: участок
например: например
любимец: любимца любимцу любимец любимцем
следующий: следующий
подобрать: подобрать
привести: привести
вещь: вещей
сказываться: сказываются
уничтожать: уничтожает
выбрать: выбрать
рассказать: расскажем
случай: случае
сразу: сразу
жизнедеятельность: жизнедеятельности
понять: понять
ощущение: ощущения
деть: день
жить: живут живущие
лестница: лестницах
несколько: несколько нескольких
жировой: жировой
питомец: питомцев питомца питомец питомцами питомцем питомцу
место: мест
предпочитать: предпочитает
тракт: тракте
горазд: гораздо
натуральный: натуральные
противопоказание: противопоказания
мы: мы
водостойкость: водостойкость
на: на
состав: составе состава
тот: том
носитель: носителя носителем
глаз: глазом
комплект: комплекте
не: не
использовать: используют использовать
барс: барс
наиболее: наиболее
суровый: суровые
указать: указанную укажите
кровь: кровью крови кровь
содержать: содержат
млекопитающее: млекопитающих
но: но
шиповать: шипованные
маленький: малы
почта: почту
нанесение: нанесения
поход: походом
внешний: внешних
три: трех
длить: для
гибель: гибели гибель
количество: количествах количество количеством
личинка: личинка личинки
принести: принести
обратить: обратите
согласно: согласно
нет: нет
корм: кормом
название: названий
развитие: развития развитием
он: он
даже: даже
от: от
невозможно: невозможно
длинный: длинной
блоха: блохи блох блохами блоха
добыча: добычей
как: как
первое: первым первого
внимание: внимание
видно: видно
все: всех
препарат: препарат
противопоказанный: противопоказан
смешать: смешать
по: по
стадий: стадия
выпускать: выпускают
безопасный: безопасных безопасные
огромный: огромное
уникальный: уникальная
самка: самка самок
немой: нем
опасный: опасны опасных опасным
разводиться: разводится
одежда: одежде
проникать: проникает
порода: пород
способ: способ
высокий: высокой
забывать: забывать
наличие: наличие наличии
признак: признаком
продукт: продукты
проверить: проверенным
цепляться: цепляться
активно: активно
переть: при
