подкладка: подкладка
специальный: специальную
бензин: бензином
день: дни дней
лед: льду
образ: образ
поведение: поведение
прогулка: прогулке
еще: еще
выйти: выйти
любить: любят
лапа: лап лапы
со: со
менее: менее
деформация: деформацию
север: севере
касаться: касается
бесплатный: бесплатной
важный: важно
под: под
проволочь: проволоки
предложить: предложите
стекло: стекла
человек: люди
а: а
прибавить: прибавьте
в: в
содержание: содержание
прихоть: прихотью
и: и
водонепроницаемый: водонепроницаемый водонепроницаемого
формироваться: формируются
к: к
о: о
подходить: подходящий
с: с
она: она
подушечка: подушечки
они: они
сезон: сезонам
ездовой: ездовым
вариант: вариант
дополняться: дополняется
наружу: наружу
препятствовать: препятствующей
слишком: слишком
пропускать: пропускает
время: время временем
весной: весной
загрязнение: загрязнения
погладить: погладьте
веселый: веселую
прорезиненный: прорезиненной
также: также
чистый: чисто
появиться: появится
получение: получения
носить: носить носят
хвалить: хвалить
понравиться: понравившиеся
следовать: следует
легко: легко
удобно: удобно
предварительно: предварительно
написать: напишем
прийтись: придется
надевать: надевали надевайте
сначала: сначала
начать: начать
воздействовать: воздействуют
выставка: выставках
подбирать: подбирать
хотя: хотя
скрываться: скрываться
слой: слоем
однако: однако
себя: собой
предназначить: предназначенные
заказать: заказать
уберечь: уберечь
потеть: потеют
пропитка: пропиткой
носиться: носились
рекомендовать: рекомендуют рекомендуем
отзыв: отзыв
повреждение: повреждения
один: одну
оценка: оценки
иметь: имеет
длина: длину
пошив: пошиве
липучка: липучках
оценить: оцените
грязь: грязи
практический: практически
неповторимый: неповторимый
ссылка: ссылке
кстати: кстати
дорогой: дорогим
некоторый: некоторое
лето: летом
надеть: наденьте надеть
функциональный: функциональная
помочь: поможет помогут
обувь: обуви обувь обувью
мерка: мерку мерки
желательно: желательно
подвести: подведем
кожа: кожу кожа
среда: среды
делать: делает делать делайте
негативный: негативно негативное негативных
комфортный: комфортная комфортную комфортнее
скидка: скидки
преимущество: преимуществом
похожий: похожим
конечность: конечностей
через: через
воспользоваться: воспользоваться
осколок: осколки
гибкий: гибкие
подойти: подошли
приучить: приучить
выгодный: выгодной
результат: результат
коготь: когтя
доставлять: доставлять
особенно: особенно
зато: зато
должен: должны должно
поставить: поставьте
опасность: опасностей
оплатить: оплатить
являться: является
временить: времени
стопа: стопу
налипнуть: налипшего
нейлон: нейлон
достаточно: достаточно
нужно: нужно
стать: стали
актуально: актуально
вызывать: вызывает
травмировать: травмировать
это: это этом этого
холодное: холодное
прочный: прочной прочный прочная прочным
поддерживать: поддерживающие
шиться: шьются
ткань: ткань ткани
обнаружить: обнаружить
два: две
удобство: удобство
покрытие: покрытием
взять: взяли взять
стоить: стоит
его: его
эффект: эффект эффектом
только: только
покупать: покупайте
сантиметр: см
скользить: скользит
тапочки: тапочки
улица: улицам улице улицу
функция: функции
дорога: дорогах
предохранять: предохраняет
или: или
возраст: возраста возрасте
неопрен: неопрен
впитываться: впитываются
чаща: чаще
теплый: теплый
защита: защита
считать: считают
воздействие: воздействие воздействий
нескользящий: нескользящей
особый: особой особым
нефтехимический: нефтехимических нефтехимической
хороший: хорошую хорошее лучше
замерзать: замерзая
наноситься: наносятся
когда: когда
учитывать: учитывайте
ботиночек: ботиночек ботиночки ботиночкам
затем: затем
чего: чего
первый: первой
вещество: веществ
масса: масса
выбираться: выбираются
лист: лист
итог: итоги
осень: осенью
стирание: стиранию
след: следа
открыть: открытые
искусственный: искусственные искусственная искусственного искусственной
мягкий: мягкие
игра: игру
ориентироваться: ориентируйтесь
лапка: лапок лапки
размер: размера размеры
спадать: спадать
ваш: вашего вашей ваш
главное: главное
так: так
иногда: иногда
четвероногий: четвероногих четвероногие четвероногого
присутствовать: присутствует
ведь: ведь
мыть: мыть
больший: больше
вентиляция: вентиляцию
фиксироваться: фиксироваться
шов: швы швами
предпочтение: предпочтение
привыкнуть: привыкнет
самый: самый самые самым
материал: материалы материалов материал материалом материала материалах
участвовать: участвующие
замша: замша замшу замши
соревнование: соревнованиях
товар: товар
выбирать: выбирайте
быть: будет быть были
шерсть: шерстью
волосок: волоски
тоже: тоже
носочек: носочки носочков носочкам
неудобный: неудобными
есть: есть
зимний: зимняя зимней
представлять: представляет
поливинилхлорид: поливинилхлорид
мочь: может можете могут
месяц: месяцев
этот: этой
сам: самого самой
четыре: четыре
неудобство: неудобства
можно: можно
воздух: воздух
основное: основное
конструкция: конструкцию
возможный: возможных
мыться: моется
снег: снега
элемент: элементами элементы
использоваться: используются
спортивный: спортивная спортивных спортивной
вес: вес
несомненный: несомненным
извинить: извините
вы: вы
оставить: оставьте
кусок: куски
отвлечь: отвлечь
словом: словом
специалист: специалисты
просто: просто
ощутить: ощутить
химический: химических
обычно: обычно
резина: резина
тем: тем
популярный: популярные
чтобы: чтобы
консультант: консультанты
цена: цене
без: без
необходимость: необходимостью необходимость
услуга: услугой
дома: дома
правильно: правильно
до: до
декоративный: декоративной декоративная декоративные
особенность: особенности
адрес: адрес
другой: другое
зоомагазин: зоомагазина зоомагазин
ее: ее
пригодиться: пригодится
посол: после
защищать: защищать
анатомический: анатомического
жаркий: жаркие
производиться: производится
вид: виды
подошва: подошве подошвой подошвы подошву
изнашиваться: изнашивается
плотный: плотные
надежно: надежно
влагоустойчивый: влагоустойчивых влагоустойчивый
умиление: умиление
демисезонный: демисезонная демисезонной
снять: снять
что: что чем
править: правило
отдавать: отдавайте
за: за
домашний: домашней
форма: форму
дом: дому
ожидать: ожидают
поверхность: поверхностью
разделить: разделить
показатель: показатель
хлопчатобумажный: хлопчатобумажная хлопчатобумажной хлопчатобумажные
зачем: зачем
лакомство: лакомством
агрессивный: агрессивны
зависеть: зависит
процедура: процедуры
статья: статье
если: если
хозяин: хозяина
голенище: голенище
любой: любым
отличаться: отличается
промышленность: промышленности
из: из
изделие: изделиям изделия
предназначение: предназначение
наш: наших
бумага: бумаги
ранний: раньше
удобный: удобная
их: их
получить: получить
контакт: контактам
заказ: заказ
зимой: зимой
следить: следите
угостить: угостите
износоустойчивый: износоустойчивым
застежка: застежку
различный: различными
керосин: керосином
нанести: нанести
обращать: обращать
прочий: прочий
год: года
защитить: защитить
собака: собака собакам собак собаки собаку
приходиться: приходится
мирно: мирно
безопасность: безопасность
повседневный: повседневная повседневной
который: которые которой которое
поэтому: поэтому
легкий: легкий
например: например
любимец: любимцу любимца
следующий: следующие
подобрать: подобрать
крайний: крайнем
выбрать: выбрать
рассказать: расскажем
хорошо: хорошо
случай: случае
сразу: сразу
создать: создать
температура: температуру
такой: такая такой
примерка: примерки примерку
мусор: мусор
нужный: нужны нужна
несколько: несколько
питомец: питомца питомцу питомцем
пясть: пясти
оптимальный: оптимальный
строение: строения
обвести: обведите
натуральный: натуральная натурального
благодаря: благодаря
широкий: широкой
раздражать: раздражают
мы: мы
летний: летняя
участие: участия
на: на
водный: водные
тот: том то те
не: не
выбор: выборе выбор
самостоятельно: самостоятельно
каждый: каждая
задний: задней задние
передний: передние
ни: ни
эластичный: эластичный
указать: укажите
измерить: измерьте
частить: части
но: но
почта: почту
вызвать: вызвано вызвать
реагент: реагентах реагентов
ношение: ношение ношения
внешний: внешней
прогуливаться: прогуливающаяся
длить: для
категория: категорий
конечный: конечный
модель: модели модель
об: об
обратить: обратите
понадобиться: понадобится
нет: нет
он: он нему
даже: даже
переходить: переходите
от: от
отмываться: отмывается
невозможно: невозможно
длинный: длинной длинного
попробовать: попробуйте попробовать
как: как
внимание: внимание
все: всего все
обеспечиваться: обеспечивается
возможность: возможности
отвечать: отвечаем
по: по
приучать: приучать
травма: травм травму
легкое: легкими легкие
асфальт: асфальт
присутствие: присутствия
одежда: одежду
очень: очень
молния: молнии
порода: породы
способ: способ
высокий: выше
забывать: забывать забывайте
какой: каким каком
наличие: наличии
аксессуар: аксессуары
продукт: продуктов продуктами
медленный: медленно
мех: меха
переть: при
