запрыгивать: запрыгивая
среда: среду
детальный: детальная
специальный: специальными
личный: личный
наш: наш
ветеринарный: ветеринарного
частота: частота
раздражение: раздражение
дозировка: дозировке
таблетка: таблетки
их: их
через: через
заказ: заказ
покупка: покупке
попросить: попросили
мочь: могут может
попадать: попадая
врач: врача
четыре: четыре
приложение: приложении
важный: важна
погода: погоду
различный: различные
мобильный: мобильном
выделять: выделяем
а: а
в: в
являться: являются
заболевание: заболеваний заболевания
гельминт: гельминтов гельминты
заразить: зараженное
проводиться: проводится
и: и
животное: животным
ознакомиться: ознакомиться
к: к
защитить: защитить
применение: применением
можно: можно
илья: илью
подходить: подходящее
о: о
домыть: домой
с: с
переносчик: переносчиков переносчиками
средство: средствам средства средство
круглый: круглый
шампунь: шампуни
нужно: нужно
сезон: сезон
они: они
клещ: клещи клещей
наступление: наступлением
поэтому: поэтому
вес: вес
уже: уже
дата: дату
вызывать: вызывают
любимец: любимец
группа: группы
раз: раз
следующий: следующей
переносить: переносят
вы: вам вы вами
это: это
обработка: обработки обработку обработка
гулять: гуляющие
оставить: оставьте
смертельный: смертельной
ошейник: ошейники
необходимо: необходимо
выбрать: выбрать выбранного
регулярный: регулярная
начинаться: начинается
температура: температуры
внутренний: внутренних
выходить: выходите
эндопаразит: эндопаразитам
жить: жить
малый: малый
составлять: составлять
капля: капли
также: также
питомец: питомцев питомцы питомца питомцем питомце
обитать: обитать
появиться: появится
улица: улице улицу
получение: получения
без: без
или: или
перед: перед
сайт: сайте
до: до
прием: приема
живете: живете
напомнить: напомним
относиться: относятся
мы: мы
слизистая: слизистых
страшный: страшных
на: на
необработанный: необработанной
находиться: находится
теплый: теплых
защита: защиту защита
адрес: адрес
вред: вред
не: не
почему: почему
каждый: каждой
указать: указана укажите
хороший: лучшая
вовремя: вовремя
устанавливаться: устанавливается
много: более
но: но
наносить: наносим
дискомфорт: дискомфорт
почта: почту
добавить: добавьте
когда: когда
учитывать: учитывайте
длить: для
период: период
начинать: начинать
система: системы
приближаться: приближается
привязать: привязаны
личинка: личинок
холодный: холодную
действие: действия
тяжелый: тяжело
ночь: ночью
рекомендовать: рекомендуем
отзыв: отзыв
вид: виды
кабинет: кабинет
постепенно: постепенно
от: от
один: одними
февраль: феврале
оценка: оценки
подвал: подвалах
оба: обе
гельминтоз: гельминтозы
блоха: блохи блох
причинять: причиняют
что: что
как: как
препарат: препарата
глист: глисты
оценить: оцените
домашние: домашним домашние
ваш: вашу вашему вашей ваш
именно: именно
главное: главного
паразит: паразиты паразитов
часть: часть
лишь: лишь
эктопаразит: эктопаразитам
последний: последнего
ожидать: ожидают
срок: срока сроке
информация: информация информацию
одинаково: одинаково
дорогой: дорого
инструкция: инструкции
активный: активны
лето: летом
опасный: опасны
помочь: поможет
зависеть: зависит
одежда: одежду
инкубационный: инкубационный
если: если
обновлять: обновлять
способ: способ
какой: какой какие какое
плюсовой: плюсовой плюсовая
протекать: протекает
товар: товар
наличие: наличии
размножаться: размножаться
традиционно: традиционно
переть: при
из: из
