выплескивать: выплескивать
состоять: состоит
несъедобный: несъедобных
новый: новом новой
исходить: исходя
есть: есть
детство: детстве
роль: роли
еще: еще
установить: установить
расслабиться: расслабиться
пакетик: пакетик
любить: любимые
физический: физическая физическую
услышать: услышать
мочь: могут может
этот: эта эту
со: со
сам: сама
благодарить: благодарен
борьба: борьбе
мышка: мышки мышкой мышку
снятие: снятия
прикрепить: прикрепить
важный: важно
предел: предела
стирать: стирать
дразнилка: дразнилки дразнилку
годовой: годовой
помощь: помощью
тута: тут
а: а
двигать: двигать двигает
изготовить: изготовлена
правило: правилам
пусть: пусть
передвигать: передвигая
в: в
мучиться: мучиться
благотворный: благотворно
кошка: кошкам кошек кошки кошка кошке кошкой кошку
и: и
охотничий: охотничьи
стресс: стресс стрессом стресса
к: к
можно: можно
о: о
отнести: отнести
дать: дайте
она: она ней нее
с: с
у: у
смочь: сможет сможете
позволить: позволит
шар: шара шары
они: им они ними ним
запас: запас
во: во
двигательный: двигательную
кошачий: кошачьей кошачья
интерактивный: интерактивные интерактивных интерактивная
уже: уже
раз: разом
попытаться: попытаться
вы: вами вы вас вам
оставить: оставит оставьте
необходимый: необходима необходимы
входить: входят
проводить: проводить
удочка: удочка
тонус: тонусе
эмоциональный: эмоциональную
условно: условно
время: время
милый: милый
социальный: социальные
свой: свою
башня: башня
обучить: обучите
свое: свои своего свое
проблема: проблемам
кошечка: кошечка
чтобы: чтобы
ветряной: ветряная
также: также
здесь: здесь
появиться: появится
получение: получения
понравиться: понравится
перед: перед
вращаться: вращаются
мебель: мебель
правильно: правильно
между: между
легко: легко
до: до
котик: котику котик
взаимоотношение: взаимоотношения
прийтись: придется
вырасти: вырастет
положить: положить
особенность: особенности
адрес: адрес
рыба: рыба
интересно: интересно
трек: треки треку трек
оставаться: оставаться
давать: давайте
ее: ее
обеспечивать: обеспечивают
дразнить: дразнить
мячик: мячиками мячик
пока: пока
закрыть: закроете
мышца: мышцы
сухой: сухого
себя: себя
платформа: платформа
чесалка: чесалки
центральный: центральный
случайно: случайно
рекомендовать: рекомендуем
крепкий: крепкими
отзыв: отзыв
достать: достать достаньте
потребность: потребности потребностей
же: же
бороться: бороться
приятный: приятный
один: одни одно одна
оценка: оценки
пораниться: пораниться поранился
нитка: нитки
двигаться: двигающимся
обязательно: обязательно
интересный: интересных
скучать: скучать
снять: снять
что: что
пример: примеры
зуб: зубов
самостоятельный: самостоятельного
предмет: предметы
за: за
оценить: оцените
рыбка: рыбка
часть: часть
удовольствие: удовольствие удовольствием
котенок: котята котенку
тренировать: тренировать
форма: форме форму
дом: доме
ожидать: ожидают
поверхность: поверхности
разделить: разделить
сторона: стороны сторону
пространство: пространства
настоящее: настоящим
некоторые: некоторым некоторые
лакомство: лакомства
помочь: помогут
пищалка: пищалками
набор: набор
середина: середине
развить: развить
если: если
укус: укусам
играться: играться
любой: любому любой
из: из
игровой: игровые игровая
перемещаться: перемещаются
негативный: негативную
казаться: кажутся казаться
серьезный: серьезным
удобный: удобна удобны
внутри: внутри
их: их
настоящий: настоящую
укреплять: укрепляют
хвост: хвостом
качество: качестве
пострадать: пострадают
ковер: ковра
заказ: заказ
шарик: шарики шариками шариком
игрушка: игрушки игрушек игрушкам игрушке игрушку игрушка игрушкой
внутрь: внутрь
покупка: покупке
удовлетворять: удовлетворяют
взрослый: взрослого взрослым
привыкать: привыкать
подойти: подойдут подойдет
следить: следите следить
восторг: восторгу
ловить: ловя
надолго: надолго
увлекательный: увлекательно
квартира: квартиры
влиять: влияет влияют
класть: кладите
мятый: мята мятой
прочий: прочие
должен: должно должны
поставить: поставить
разный: разные разными
бывать: бывают
проглотить: проглотить проглотил
получать: получать
будущее: будущего
гранула: гранулы
машина: машине
навык: навыки
бубенчик: бубенчиками
забота: заботу
ко: ко
стараться: стараясь
никуда: никуда
интерес: интерес
зарядный: зарядное
лазерный: лазерные лазерной
который: которое которые которую которая
вывод: выводы
поэтому: поэтому
отличный: отличный
заставлять: заставляйте заставляя
квадрат: квадрат
выслеживать: выслеживать
совместный: совместных
это: это этим
прочный: прочного
поддерживать: поддерживать поддерживают
поедание: поеданию
привести: приведут
пружина: пружине
два: две два
вот: вот
хорошо: хорошо
указка: указки
светящийся: светящийся
настроить: настроена
кот: кота
его: его
такой: такие таким такой
интеллектуальный: интеллектуальном
понять: понять
строгий: строго
чехол: чехол
только: только
разноцветный: разноцветными
покупать: покупайте покупая
сантиметр: см
несколько: несколько
питомец: питомца питомец
нельзя: нельзя
отдельно: отдельно
мельница: мельница
или: или
никакой: никакой никаких
рука: руками
возраст: возрасте
относиться: относятся
ровный: ровной
включать: включая
мы: мы
перечислить: перечислим
точно: точно
на: на
состав: составе
тот: то те та
не: не
использовать: используйте использовать
почему: почему
указать: укажите
охотиться: охотиться
хороший: хорошей хорошие лучше
но: но
маленький: маленькие маленького
почта: почту
красный: красной
разрешать: разрешайте
когда: когда
вызвать: вызовет вызвать
замкнутый: замкнутого
играть: играют играть играли играя
три: тремя
перо: пером
длить: для
клык: клыками
склонить: склонен
царапина: царапинам
забавный: забавными
общий: общее
нет: нет
клоун: клоун
развитие: развитии
он: он него ему
состояние: состояние
даже: даже
охотник: охотника
пять: пять
от: от
заряжаться: заряжается
зрелый: зрелом
идти: идет
дизайн: дизайн
способствовать: способствуют
мягкий: мягкими
стимулировать: стимулируют
игра: игры игр
примерный: примерно
как: как
первое: первое первым
лапка: лапками
все: все
условие: условиях
помогать: помогает помогают
ваш: ваши вашими ваш вашу ваше вашей
так: так
по: по
равнодушный: равнодушной
устойчивый: устойчива
ведь: ведь
стержень: стержень
прилагаться: прилагается прилагаются
склонный: склонны
занять: занять
круг: круг
позволять: позволяют
реакция: реакцию
самый: самых
инстинкт: инстинкты
освоиться: освоиться
способ: способ
товар: товар
наличие: наличии
второе: вторым
выбирать: выбирайте
быть: быть будут будете будет суть
яркий: яркие
никак: никак
активно: активно
переть: при
