приводить: приводит
специальный: специальное специальную специальных
кормовой: кормовыми
день: дней дня
таблетка: таблетки таблетке таблетка таблетку таблеток
частично: частично
выйти: выйти
рот: рот
любить: любит
попросить: попросите
любимица: любимице
юридический: юридический
аллергия: аллергии
а: а
человек: человек
в: в
помещение: помещение
пункт: пункт
и: и
к: к
о: о
с: с
она: она нее
средство: средства средств
у: у
применять: применяют
течение: течение
определить: определить
клещ: клещей
они: них они ним
оно: оно
возникновение: возникновение
блистер: блистерам
необходимый: необходимого
поместить: поместите
входить: входящие
кормить: кормящих кормящим
пропускать: пропускать
быстро: быстро
разрушать: разрушает
глотать: глотать
ооо: ооо
погладить: погладьте
соответствующий: соответствующего
также: также
корма: кормами
индивидуальный: индивидуальной
появиться: появится
получение: получения
следовать: следуйте следует
прием: прием
легко: легко
лактация: лактации
родить: родившей
отсутствие: отсутствие
какой-либо: каких-либо какую-либо
закрыть: закройте
себя: собой
офис: офис
рекомендоваться: рекомендуется
совместимость: совместимости
случайно: случайно
рекомендовать: рекомендуем
отзыв: отзывам отзывы отзыв
приятный: приятным
купить: купить
один: одной один одно
оценка: оценки
иметь: имеют имеет
совет: совета
глистный: глистной глистных
пользоваться: пользуйтесь
оценить: оцените
выход: выходу
продуктивный: продуктивных
московский: московская
сторона: стороны
инструкция: инструкции
некоторые: некоторые
помочь: помогут
привлекательный: привлекательный
целовать: целую
тереть: три
описание: описание
поедать: поедают
процесс: процесс
минимизировать: минимизируете
недостаток: недостаткам недостатки
кожа: кожу
хранить: хранить храните
среди: среди
выдавить: выдавите
кишечник: кишечника
качество: качестве
преимущество: преимущества
через: через
воспользоваться: воспользоваться
анкилостомоз: анкилостомоз
замена: замену
взрослый: взрослых взрослым
отдельный: отдельную
смерть: смерти
соблюдение: соблюдении
назначить: назначит
должен: должен
из-за: из-за
животное: животному животного животных
температурный: температурный
хотеть: хочет
эффективность: эффективность
весомый: весом
облегчать: облегчает
половина: половине
нужно: нужно
обладать: обладают
понос: понос
немедленно: немедленно
обработка: обработки
это: этого это этом этим
вкус: вкус вкусом
смачиваемость: смачиваемости
кой: коем
взять: возьмите
консультация: консультации
кот: коту
стоить: стоит
его: его
справиться: справиться
улучшать: улучшает
пустой: пустую
уложить: уложен
эффект: эффекты эффектов
только: только
дегельминтизация: дегельминтизацию
покупать: покупать
планирование: планирования
ветеринар: ветеринаром ветеринара
нельзя: нельзя
заражение: заражения заражении
коробка: коробку
или: или
далеко: далеко
передозировка: передозировке
возраст: возраст возрасте
относиться: относятся
особо: особо
вспомогательный: вспомогательные
подсказать: подсказать
энергетический: энергетические
уход: уходе
особый: особей
хороший: лучше
много: много
предполагать: предполагаемых
испортить: испорченные
когда: когда
затем: затем
обычный: обычные
нарушение: нарушении
поршень: поршень
болезнь: болезни
разрешить: разрешено
вещество: вещества вещество
масса: массы
скармливание: скармливания
обязательный: обязательный
всасываться: всасываются
открыть: откройте
вопрос: вопросе
лактоза: лактозу
наблюдаться: наблюдается наблюдаются
компания: компания
ориентироваться: ориентируйтесь
лечебный: лечебными
против: против
ваш: вашей ваш
так: так
где: где
больший: большим
промыть: промойте
кто: кто
попадание: попадании
позволять: позволяет
использование: использования использование использовании
неделя: недель недели
самый: самая
добавка: добавка добавку
товар: товар
быть: были быть будет
отмечать: отмечали
дозировка: дозировку дозировка
есть: есть
желчь: желчью
мочь: могут
этот: этот этими эти этих
сам: сами
рассчитываться: рассчитывается
расфасовать: расфасованы
гельминт: гельминтов
кошка: кошек кошки кошку кошкам кошке
терапевтический: терапевтического
можно: можно
применение: применению применения
основное: основным основное
отнести: отнести
дать: дать дали данные
почтить: почти
действовать: действует действуют действующее
позволить: позволит
смочь: смогут сможет
использоваться: используется
таблетировать: таблетируемых
вес: вес
хранение: хранения
уже: уже
больной: больным
раз: раз
цвет: цвет
того: того
вы: вы вам вас
сажать: сажать
оставить: оставьте
варьироваться: варьируется
проводить: проводить
соблюдать: соблюдать соблюдайте
просто: просто
побочный: побочные побочных
растворимость: растворимости
снижать: снижает
россия: россии
щенок: щенкам
свое: своего
тем: тем
противопаразитарный: противопаразитарные
устройство: устройство
без: без
привередливый: привередливые
перед: перед
до: до
положить: положите
особенность: особенности
адрес: адрес
другой: другой другими другим
разрешаться: разрешается
клетка: клетках
работа: работу
весить: весит
давать: давать дает
ее: ее
проконсультироваться: проконсультируйтесь
иначе: иначе
посол: после
логотип: логотип
период: период
вид: вид виде
достать: достать
влага: влаги
кроме: кроме
вымыть: вымойте
попасть: попал
диапазон: диапазон
что: что
за: за
спектр: спектра
паразит: паразитов паразитами
удовольствие: удовольствием
котенок: котятам
нажать: нажмите
ожидать: ожидают
применяться: применяется применяются
глотательный: глотательный
существовать: существуют
статья: статье
если: если
повод: поводу
любой: любой любом
захотеть: захотят
организм: организм
из: из
прекратить: прекратить
естественный: естественному естественным
удобный: удобное
их: их
компонент: компонентам компонентов
разве: разве
близкие: близких
нарушать: нарушает нарушают
заказ: заказ
пасть: пасть
доза: дозе
вдали: вдали
сделать: сделать
диета: диету
закрытый: закрытой
примечательно: примечательно
белый: белого
разный: разные разными разных
проглотить: проглотил
стенка: стенки
кто-то: кого-то
кг: кг
истощить: истощенным
обратиться: обратитесь обратиться
собака: собак собакам
упаковка: упаковку упаковке
лечение: лечения
кальций: кальция
малыш: малыш малышей
безопасность: безопасность
беременная: беременных беременную беременным
который: котором которые которых
вывод: выводы
выведение: выведения
крупный: крупная
следующий: следующие следующих следующим
ли: ли
непереносимость: непереносимости
рассказать: расскажем
инструмент: инструмент
случай: случае случаях
сразу: сразу
спровоцировать: спровоцирует
такой: таких
плюс: плюсам
деть: день
вместе: вместе
вынуть: выньте
питомец: питомцу питомца питомцев питомец питомцам
вкусовой: вкусовая вкусовую
место: месте
безопасно: безопасно
оптимальный: оптимальная
корень: корень
широкий: широкого
противопоказание: противопоказания
мы: мы
просрочить: просроченные
на: на
состав: состав
тот: то тех
не: не
использовать: использовать используйте
каждый: каждый каждой
указать: указаны указанные укажите
ни: ни
кровь: кровь
содержать: содержит содержат
но: но
почта: почту
появление: появления
длить: для
гибель: гибели
обрабатывать: обрабатывать
количество: количеством
об: об
личинка: личинок
растворение: растворению
сыпучесть: сыпучесть
нет: нет
корм: кормов
он: он него
развитие: развития
даже: даже
показание: показания
от: от
наконечник: наконечник
способствовать: способствует
попробовать: попробовать
смазывать: смазывает
как: как
все: всех всего всем все
принимать: принимать принимают
препарат: препараты препаратов препарат препарате препарата препаратами
глист: глистов глистами
противопоказанный: противопоказан
условие: условия
помогать: помогает
по: по
отсутствовать: отсутствуют
стадий: стадиях
выпускать: выпускает выпускаемый
выпуск: выпуску
прилагаться: прилагающуюся
склонный: склонные
усилить: усилить
картофельный: картофельный
риск: риск
очень: очень
выводиться: выводится
способ: способы способ
высокий: высокая
какой: каких какую
наличие: наличии
переть: при
