долгий: долго
стандартный: стандартной
лента: ленты ленте ленту
темный: темное
черный: черном
нагрузка: нагрузка нагрузку
поведение: поведением
внимательно: внимательно
прогулка: прогулки прогулок прогулкой
пакетик: пакетики
дефект: дефектов
мочь: можете
вокруг: вокруг
этот: эта
со: со
остановить: остановить остановите
прикрепить: прикрепите
важный: важным
исправный: исправном
друг: другом
под: под
изготовить: изготовлены
дополнительно: дополнительно
а: а
в: в
основной: основных
бесшумный: бесшумным
пункт: пунктом
и: и
помещаться: помещается
к: к
м: м
подходить: подходит
о: о
дать: данная данные данной
с: с
она: она
у: у
определить: определенной
течение: течение
гарантия: гарантия гарантии
вес: веса
стремиться: стремимся
дата: даты
базовый: базовые
цвет: цвете
вы: вы вас вам
свободно: свободно
оставить: оставьте
теперь: теперь
разматывание: разматывания
поместить: помещен
запутывание: запутывания
возвратный: возвратным
фонарик: фонарики фонариком
необходимо: необходимо
время: время
кнопка: кнопкой кнопка кнопку
забыть: забудете
простой: простых
раскручиваться: раскручивается
нажатие: нажатием
свое: своим
разблокировка: разблокировки
проблема: проблемы
соответствующий: соответствующую
максимально: максимально
чтобы: чтобы
также: также
индивидуальный: индивидуальным
появиться: появится
предосторожность: предосторожности
устройство: устройство
получение: получения
комплектация: комплектации
комфорт: комфорт
карликовый: карликовых
необходимость: необходимости
перед: перед
дома: дома
плавно: плавно
правильно: правильно
магнитный: магнитные магнитным
легко: легко
до: до
удобно: удобно
тянуть: тянуть
распространяться: распространяется
мелкий: мелких
находиться: находится
ежедневный: ежедневных
адрес: адрес
другой: других
представить: представлены
поводковый: поводков
давать: дает
ее: ее
обеспечивать: обеспечивая
разматываться: разматываться
период: периода
вытягивание: вытягиванием
контроль: контроль контроля
рекомендовать: рекомендуем
отзыв: отзыв
потребность: потребностям
вид: виды виде
же: же
подзарядка: подзарядки
приятный: приятными
пластиковый: пластиковый
один: одним
повреждение: повреждения
оценка: оценки
иметь: имеет имеют
надежно: надежно
длина: длину длина
что: что
мера: меры
контролировать: контролируемых
за: за
оценить: оцените
домашние: домашними
неправильный: неправильным
выход: выход
практический: практически
свобода: свободу
нажать: нажмите
ожидать: ожидают
сматывание: сматыванием
активность: активности
удерживать: удерживайте
инструкция: инструкцию инструкция
наслаждаться: наслаждайтесь
некоторые: некоторые
рулетка: рулетками рулетки рулетка рулеток рулетку
бренд: бренда
если: если
современный: современных
надежность: надежность
помимо: помимо
укус: укусами
поддержать: поддержите
фиксация: фиксации
ассортимент: ассортимент
избежать: избежать
из: из
заменить: заменят
уборка: уборки
рукоятка: рукоятку
хранить: хранить
обнаружение: обнаружения
подставка: подставки
удобный: удобной удобным
кольцо: кольцо кольцу
многие: многих
комфортный: комфортными
преимущество: преимущества
заказ: заказ
подойти: подойдет
следить: следите
вставка: вставками
сделать: сделать
спаниель: спаниель
ударопрочный: ударопрочным ударопрочный
окружать: окружающей
разный: разных
передвинуть: передвиньте
удлиненный: удлиненный
никогда: никогда
движение: движений движением движение
пакет: пакетов
ручка: ручкой ручка
прослужить: прослужила прослужит
обратиться: обратиться
собака: собак собаки собаке
весомый: весом
поводок: поводка
стать: стали станет
нужно: нужно
безопасность: безопасности
зарядный: зарядное
закрепить: закрепите
работать: работала работает
повседневный: повседневной
который: которой который
чистота: чистоту
крупный: крупных
немедленно: немедленно
прочный: прочной
вне: вне
зарядка: зарядкой
подобрать: подберите
ошейник: ошейнике ошейника
два: двух
обнаружить: обнаружены
выбрать: выбрать
удобство: удобства
сегодня: сегодня
изучить: изучите
фонарь: фонарем
случай: случае
взять: возьмите
такой: такая
иметься: имеется
вместе: вместе
только: только
жизнь: жизни
палец: пальцем
рычаг: рычаг
надежный: надежным надежный
несколько: нескольких
питомец: питомцами питомцем питомцу
пудель: пуделей
средний: средних
улица: улицу
держать: держит
место: место
брак: брака
оптимальный: оптимальную оптимально
или: или
лабрадор: лабрадоров
рука: рук
широкий: широкий
включать: включает
мы: мы
на: на
комплект: комплекте
не: не
уход: ухода
нескользящий: нескользящей
использовать: использовать используйте
каждый: каждая
гарантийный: гарантийный гарантийного
шлейка: шлейке
указать: укажите
но: но
почта: почту
объект: объектов
разрешать: разрешайте
выпускаться: выпускаются
вызвать: вызванные
когда: когда
рассчитать: рассчитана
учитывать: учитывайте
длить: для
карабин: карабин
категория: категории
начинать: начиная
размотка: размотки размотку
модель: модель модели
моментальный: моментальный
рулон: рулон
механизм: механизма механизм механизмом
нет: нет
плавной: плавным
он: он
даже: даже
корпус: корпус корпусе
от: от
обязательный: обязательным
держатель: держателем
крутиться: крутящийся
выполнить: выполнены
придерживаться: придерживаться
тогда: тогда
хвататься: хватайтесь
размер: размеру размеров размер размера
все: все
условие: условия
ваш: ваши вашему вашего вашей ваш
ощущать: ощущая
оснастить: оснащена оснащены
по: по
четвероногий: четвероногим
возникнуть: возникнут
больший: больших
срок: срок
где: где
безопасный: безопаснее безопасных
травма: травмы
событие: событием
позволять: позволяет позволяют позволяйте
зафиксировать: зафиксировать
выгул: выгула
использование: использовании использованием использованию
торможение: торможения
допустимый: допустимая
способ: способ
высокий: высокую
товар: товаров товар
наличие: наличии
аксессуар: аксессуарами
яркий: яркими
переть: при
