поездка: поездок
расправляться: расправляются
специальный: специальными
яйцо: яйца
таблетка: таблетки
есть: есть
происходить: происходит
еще: еще
район: район
ребенок: детей
недоступный: недоступном
путешествие: путешествий
касаться: касается
растекаться: растекаются
выделять: выделяют
пол: полы
в: в
помещение: помещений помещения
кошка: кошек кошка
и: и
прочитать: прочитайте
к: к
можно: можно
применение: применением
о: о
подходить: подходящего
вероятность: вероятность
с: с
средство: средства средствами
действовать: действуют
у: у
шампунь: шампуни
определить: определенные
лекарство: лекарства лекарством
невнимание: невниманию
безвредный: безвредны
смочь: сможет
они: они ими них
во: во
уделять: уделять
вариант: вариант
хранение: хранения
того: того
вы: вы вас
оставить: оставьте
сложность: сложность
проводить: проводите
соблюдать: соблюдайте соблюдать
кормить: кормящая
время: время
регулярный: регулярных
забыть: забудьте
внутренний: внутренних
свой: своей
ветврач: ветврача
свое: своих своего своему
чтобы: чтобы
появиться: появится
предосторожность: предосторожности
получение: получения
перед: перед
удобно: удобно
написать: напишем
адрес: адрес
вред: вреда
симптом: симптомов
отпугивать: отпугивают
давать: даете
вовремя: вовремя
отсутствие: отсутствии
проконсультироваться: проконсультироваться
посол: после
отзыв: отзыв
вид: видов
же: же
грызун: грызунов
вымыть: вымыть
один: одних
оценка: оценки
откладывать: откладывают
помыть: помойте
превышение: превышении
что: что
мера: меры
за: за
оценить: оцените
домашние: домашних
паразит: паразитов
котенок: котенка
отравиться: отравиться
форма: форме
ожидать: ожидают
возникать: возникает
инструкция: инструкции
точечный: точечно
несоблюдение: несоблюдении
часто: часто
зависеть: зависит
если: если
процесс: процесс
минимизировать: минимизировать
обработать: обработали
хранить: храните
среди: среди
удобный: удобны
их: их
многие: многие
заказ: заказ
воспользоваться: воспользуйтесь
пудра: пудры
фактор: факторам
следить: следите
тщательно: тщательно
особенно: особенно
тело: телу
большой: велика
разный: разных
случайность: случайности
животное: животных
обратиться: обратитесь
собака: собак собака
упаковка: упаковки
эффективность: эффективность
нужно: нужно
беременная: беременная
который: которых которые
вывод: выводы
холка: холку
немедленно: немедленно
смешение: смешении
следующий: следующих
это: это этом этого
обработка: обработки
большинство: большинства
подобрать: подобрали
ли: ли
вещь: вещей
ошейник: ошейники
два: два
слизывать: слизывали
случай: случае
сразу: сразу
его: его
такой: такое таких
плюс: плюса
отравление: отравления
ветеринар: ветеринаром
капля: капли капель
несколько: несколько
питомец: питомцы питомец
заражение: заражения
или: или
рука: руки
возраст: возраст
мы: мы
устойчивость: устойчивость
на: на
тот: те то
не: не
использовать: использовать использованные
выбор: выборе выбору
особый: особое
указать: указанной укажите
содержать: содержат
хороший: лучше
слизать: слизать слизала
маленький: маленького
но: но
почта: почту
наноситься: наносятся
нанесение: нанесении нанесения
купировать: купировать
когда: когда
проветрить: проветрите
идеальный: идеальный
внешний: внешним внешних
страдать: страдают
появление: появлении
длить: для
обрабатывать: обрабатывать
разделяться: разделяются
общий: общих
дача: дачи
он: он
даже: даже
от: от
все-таки: все-таки
блоха: блохи
как: как
ориентироваться: ориентируйтесь
внимание: внимание
все: всего все
препарат: препарата препараты препаратов
условие: условий условия
ваш: ваш вашей
против: против
так: так
по: по
рекомендация: рекомендаций
ведь: ведь
мыть: мыть
прилагаться: прилагающуюся
безопасный: безопасны
системность: системность
риск: риск
порода: породу
элементарный: элементарные
способ: способ
какой: какие
товар: товар
наличие: наличии
признак: признакам
переть: при
