состоять: состоит
специальный: специальным
день: дней
таблетка: таблетки таблетку таблетками
диагностик: диагностика
еще: еще
мама: мама
заключаться: заключается
ребенок: дети детям
эффективный: эффективные
лапа: лапы
любимица: любимице
трематода: трематоды
обнаруживаться: обнаруживаются
со: со
важный: важно
касаться: касается
пойти: пойти
содержимое: содержимое
под: под
множество: множество
а: а
вода: водой
человек: человека человеку человек
в: в
и: и
качественный: качественными
живой: живых
к: к
о: о
насколько: насколько
с: с
средство: средства средств
у: у
новорожденная: новорожденных
передаваться: передаваться
непроходимость: непроходимость
применять: применять
течение: течение
определить: определенный
область: область
они: ним они них
владелец: владелец
внутриутробный: внутриутробно
иммунный: иммунную
сила: силы
распознать: распознать
необходимый: необходимые необходима
поместить: поместить
входить: входит
раздвинуть: раздвинуть
кормить: кормить
небольшой: небольшое небольшим
время: время
посоветоваться: посоветуйтесь
дезинфицировать: дезинфицирующее
внутренний: внутренних внутренние
сердечная: сердечных
погладить: погладить
ранее: ранее
ситуация: ситуации
плановый: плановой
также: также
корма: корма
обитать: обитают
индивидуальный: индивидуальную
появиться: появится
предосторожность: предосторожности
получение: получения
следовать: следует
прием: приеме
легко: легко
удобно: удобно
предварительно: предварительно
допускать: допускайте
облизать: облизала
раскрошить: раскрошить
зависимость: зависимости
находиться: находящихся
употреблять: употребляют
вред: вред
подрывать: подрывает
лоток: лотка
подбирать: подбираемых подбирать
шприц: шприц
постельный: постельных
однако: однако
закрыть: закрыть
описать: описали
тяжелый: тяжелых
черви: черви
рекомендовать: рекомендуем
отзыв: отзыв
один: одна
оценка: оценки
обязательно: обязательно
иметь: имеет имеют
снизить: снизить
гельминтоз: гельминтоза гельминтоз
плоский: плоские
мера: меры мер
оценить: оцените
выход: выход
практический: практически
повреждать: повреждают
часто: часто
надеть: наденьте
некоторые: некоторые некоторых
помочь: помогут помочь
помимо: помимо
привлекательный: привлекательные
избежать: избежать
подвести: подведем
способность: способностью
способный: способны
кожа: кожу
среда: среду
уборка: уборке
обработать: обработана
разноситься: разносятся
грудной: грудном
через: через
воспользоваться: воспользоваться
становиться: становится
прочить: прочь
результат: результате
особенно: особенно
большой: велик
опасность: опасность
являться: является
бывать: бывают
заразить: заражена зараженный заражены зараженными заражено
проводиться: проводится
животное: животного животных животными
плацентарный: плацентарный
рвотное: рвотных
достаточно: достаточно
нужно: нужно
возможно: возможно
провести: проведет провести
это: это этом этого
обработка: обработки обработку
большинство: большинство
ткань: ткани
вкус: вкус
обнаружить: обнаружить обнаружили
изучить: изучить
ограничить: ограничить
вряд: вряд
суспензия: суспензию суспензиями
стоить: стоит
консультация: консультация консультацией
его: его
справиться: справиться
только: только
дегельминтизация: дегельминтизация
менять: меняйте
капля: капли
нельзя: нельзя
заражение: заражение заражения
или: или
далеко: далеко
особо: особо
особь: особи
чаща: чаще
защита: защитой
хороший: лучшей
наносить: наносит
основываться: основываясь
наноситься: наносятся
когда: когда
употребить: употребил
профилактика: профилактикой профилактика
фрагмент: фрагменты
ленточный: ленточных
первый: первую
разрешить: разрешено
остановиться: остановимся
состояние: состояние
заразиться: заразится заразиться
наверняка: наверняка
итог: итоги
стимулировать: стимулируя
наблюдаться: наблюдается
против: против
ваш: вашей ваш
иногда: иногда
резиновый: резиновые
четвероногий: четвероногий четвероногому четвероногого
рекомендация: рекомендации
печальный: печального
ведь: ведь
срок: срок
мыть: мойте
постараться: постарайтесь
дальнейший: дальнейшем дальнейших
зафиксировать: зафиксировать
неделя: недель
самый: самая
вливать: вливать
товар: товар
выбирать: выбираете
быть: быть была
печень: печень
вывести: вывести
приспособление: приспособлением
частота: частота
яйцо: яйца
мерный: мерный
передаться: передаться
неповрежденный: неповрежденную
есть: есть
ряд: ряд ряда
мочь: может могут
попадать: попадают
месяц: месяца
пищеварительный: пищеварительного
этот: эти этот
сам: сам сами
потомство: потомство
вирусный: вирусным
основной: основные
гельминт: гельминты гельминтами гельминтов
схема: схему
кошка: кошки кошка кошек
удаться: удастся
можно: можно
применение: применением применение
фиксировать: фиксировать
дать: дать даст
почтить: почти
утилизировать: утилизируйте
производитель: производители
во: во
оказываться: оказываются
своевременный: своевременная своевременной
перечень: перечень
уже: уже
дата: дату
бросать: бросает
вакцинация: вакцинацией
раз: раз
того: того
вы: вы
оставить: оставьте
проводить: проводя проводить
необходимо: необходимо
специалист: специалист
соблюдать: соблюдать соблюдайте
чувствовать: чувствует
регулярный: регулярной
оболочка: оболочку
поражать: поражать
щенок: щенкам щенки щенков
обычно: обычно
свое: свои
популярный: популярная
чтобы: чтобы
без: без
перед: перед
шерстить: шерсти
слегка: слегка
до: до
особенность: особенностей особенности
адрес: адрес
другой: другие
весить: весь
давать: давать
вовремя: вовремя
ее: ее
пожилой: пожилым
терапия: терапия
психологический: психологическом
посол: после
период: период
число: числе
порекомендовать: порекомендует
контроль: контролем
повредить: поврежденные
термический: термической
беременность: беременности
каловый: каловых
заподозрить: заподозрить
вид: видов видами виды виде
же: же
грызун: грызунами
купать: купать
везде: везде
путь: путь
что: что чем
подверженный: подвержен
за: за
будущий: будущая
предмет: предметах
домашние: домашних домашними
паразит: паразитами паразитов
котенок: котята котятам котят
рождаться: рождаются
домашний: домашнего
форма: форма
спрятать: спрятать
ожидать: ожидают
показатель: показателях
точечный: точечно
лакомство: лакомство
желудочно-кишечный: желудочно-кишечный
глотательный: глотательное
существовать: существует
если: если
хозяин: хозяин
отличаться: отличаются
организм: организмах организм организме
из: из
инъекция: инъекции
наш: наших наши
поглаживание: поглаживании
ветеринарный: ветеринарного ветеринарному ветеринарной ветеринарным
серьезный: серьезный
ранний: раньше
их: их
бактериальный: бактериальным
контакт: контакты контактов контакта контакт
язык: языка
заказ: заказ
пасть: пасть
объяснить: объяснить
тщательно: тщательно
здоровье: здоровью здоровья
нанести: нанести
неокрепший: неокрепший
влажный: влажной
нормализовать: нормализовать
назначать: назначают
обратиться: обратитесь обратиться
симптоматика: симптоматика
собака: собаки собака
характерный: характерная
упаковка: упаковку
лечение: лечение
круглый: круглые круглых
малыш: малышей
беременная: беременной
который: которые которой которую который которых которое
неспецифический: неспецифическую
поэтому: поэтому
токсичный: токсичные
холка: холку холки
чистота: чистоту
любимец: любимца любимец любимцем любимцам
подобрать: подберет
ли: ли
привести: привести
сказываться: сказывается
вот: вот
пропустить: пропустить
случай: случаях случае
такой: такие такое
вместе: вместе
жить: живущее живущими
несколько: несколькими
питомец: питомцев питомец питомца питомцы
рука: руки
натуральный: натуральную
корень: корень
противопоказание: противопоказание противопоказания
мы: мы
слизистая: слизистую
на: на
какой-то: какое-то
тот: том то
не: не
использовать: используйте
наиболее: наиболее
каждый: каждом
указать: укажите
но: но
поздний: позже
маленький: маленькие
почта: почту
щадить: щадящее
вызвать: вызвать
выпускаться: выпускаются
внешний: внешней внешних внешнюю
длить: для
количество: количество количеством
личинка: личинки
повторять: повторять
орган: органы
он: он
даже: даже
от: от
как: как
кал: калом
все: всему все
принимать: принимать
препарат: препараты препаратов препарат
глист: глисты глистами глистов
условие: условиях условия
значительно: значительно
смешать: смешать
по: по
антигельминтный: антигельминтных
выпускать: выпускают
слюна: слюной
самка: самки
опасный: опасным опасных опасен опасны
принять: принять принятых
постоянно: постоянно
риск: риск
зачатие: зачатия
проникать: проникать
способ: способ
высокий: высокой
забывать: забывать забывайте
наличие: наличие наличии
медленный: медленно
переть: при
