поездка: поездка поездке поездки
долгий: долгие
дачный: дачном
специальный: специальные
комар: комаров
новый: новую новые
день: дня дни дней
металл: металла
образ: образом
поведение: поведение
найти: найти нашедший
еще: еще
прогулка: прогулки прогулок
пакетик: пакетик
любить: любимого любимым любимый любит любимую любимая
эффективный: эффективно
любимица: любимицы
со: со
путешествие: путешествия
застать: застала
прикрепить: прикрепите
важный: важно важный
хлопковый: хлопковых
полный: полного
помощь: помощью
пол: полы
связаться: связаться
а: а
дополнительно: дополнительно
вода: водой
в: в
заглянуть: загляните
заболевание: заболеваниями
трудный: трудно
помещение: помещениях
пункт: пункт
лес: лесу
и: и
качественный: качественные
к: к
времяпрепровождение: времяпрепровождению времяпрепровождение времяпрепровождения
неотапливаемый: неотапливаемых
о: о
подходить: подходить
с: с
она: она нее
средство: средства средством
у: у
шампунь: шампуня шампунем шампунь
течение: течение
запах: запахи
они: они них
дополнительный: дополнительной
запас: запас
вольер: вольер
отпускать: отпускать
наступить: наступило
обеспечить: обеспечить обеспечит
запастись: запастись
похвастаться: похвастаться
необходимый: необходимы необходимым необходим
весьма: весьма
автомобильный: автомобильный
небольшой: небольшая небольших
время: временем время
загрязнение: загрязнениями
забыть: забыть забудьте забыли
поощрение: поощрения
про: про
сильный: сильный
плановый: плановой
проблема: проблемы
также: также
чистый: чистой
корма: корма корм
индивидуальный: индивидуально
появиться: появится
город: городом городе
отвлекать: отвлекали
получение: получения
следовать: следует
легко: легко
снова: снова
находиться: находиться находясь
употреблять: употребляет
постирать: постирайте
посторонний: посторонние
начать: начать
сидеть: сидеть
требовать: требует
рисковать: рискуете
лоток: лоток
подбирать: подбирать
какой-либо: каким-либо
однако: однако
порядок: порядке
себя: себя собой
предназначить: предназначенные
часы: часов
пренебрегать: пренебрегайте пренебрегать
намордник: намордник
читать: читайте
тяжелый: тяжелых
сколько: сколько
сквозняк: сквозняков
рекомендовать: рекомендуем
преподносить: преподносит
отзыв: отзыв
прямая: прямых
пластиковый: пластиковую
один: один одна
оценка: оценки
обязательно: обязательно
иметь: иметь имеет
значительный: значительные
мера: меры
жар: жару
громкий: громко
собачка: собачек
оценить: оцените
последний: последний
класс: класса
минута: минут
повернуть: повернуть
дорогой: дороги
крепиться: крепится
часто: часто
некоторые: некоторые
помочь: помогут поможет
укус: укусы
избежать: избежать
желательно: желательно
подвести: подведем
потерять: потерять
привычка: привычка
уборка: уборки
делать: делать
негативный: негативно
обработать: обработать
повторить: повторите
комфортный: комфортным
номер: номер
качество: качестве
через: через
воспользоваться: воспользуйтесь
подойти: подойдут подойдет
приучить: приучите
врач: врачу
отдельный: отдельный отдельную
доставлять: доставляют
прилечь: прилечь
особенно: особенно
должен: должен должно должны
случайность: случайностей
курточка: курточку
впитать: впитает
предстоять: предстоит
мисочка: мисочек
подготовка: подготовки подготовку подготовка
салфетка: салфетки
непривычный: непривычным
нужно: нужно
актуально: актуально
осваивать: осваивают
порция: порцию
металлический: металлическую
это: это этом этого
обработка: обработки
гулять: гуляет гулять
ограничивать: ограничивать
еда: еды
два: двух
обнаружить: обнаружит обнаружили
ошейник: ошейник
прочность: прочность
достойный: достойную
сказаться: скажутся
взять: взять возьмите
его: его
справиться: справиться
светодиодный: светодиодными
неприятный: неприятных
заблаговременно: заблаговременно
принадлежность: принадлежности
жизнь: жизни
только: только
капля: капель
средний: средней
дорога: дорогу
заражение: заражения
пеленка: пеленкой
наполнитель: наполнителя наполнителем наполнитель
или: или
звук: звуки
питьевой: питьевой
особо: особо
защита: защита защиты
теплый: теплый теплую
минимум: минимум
подумать: подумайте
рубашечка: рубашечки
осадки: осадков
хороший: лучше хорошее
спокойный: спокойно спокойнее
много: много более
пристегивание: пристегивания
стачивать: стачивают
когда: когда
застелить: застелить
вкусный: вкусного
играть: играют
готовиться: готовиться
учитывать: учитывайте учитывать
учесть: учесть
контейнер: контейнере
дача: дачу дачи даче дача
наверняка: наверняка
итог: итоги
обязательный: обязательном
захватить: захватить захватите
приобрести: приобрести приобретите
мягкий: мягкий
никто: никто
поскольку: поскольку
уютный: уютное
размер: размер
переход: переход
ваш: ваш ваша вашего вашей
именно: именно
так: так
главное: главное
светоотражающий: светоотражающими
иногда: иногда
четвероногий: четвероногого четвероногий
печальный: печальному печальным
голова: голову
ведь: ведь
где: где
постараться: постарайтесь
активный: активные
зайти: зайти
предпочтение: предпочтение
привыкнуть: привыкли
пора: пора
материал: материал
товар: товар
быть: было будет быть
что-то: что-то
автомобиль: автомобиль
налить: налить
тоже: тоже
успокоительный: успокоительное
темный: темное
достаточный: достаточное
вести: вести
пахнуть: пахнет
есть: есть
заодно: заодно
внимательно: внимательно
мяукать: мяукать
установить: установите
лепесток: лепестком
кровососущий: кровососущих
лишний: лишней
вдруг: вдруг
приобретение: приобретении
мочь: могут может
месяц: месяцы
сам: самое
погода: погода
замок: замков
убивать: убивают
амуниция: амуницию амуниции амуниция
гельминт: гельминтов
кошка: кошка кошек кошке
стресс: стресс
можно: можно
применение: применением
воздух: воздухе
дать: дать
болезненный: болезненные
возможный: возможна возможны
элемент: элементов
смочь: сможет
во: во
третий: третья
уже: уже
раз: раз
вы: вас вы вам
магазин: магазинах
свободно: свободно
оставить: оставьте
одноразовый: одноразовой
ствол: стволы
паспорт: паспорт
солнечный: солнечных
отвлечь: отвлечет
необходимо: необходимо
обойтись: обойтись
спустя: спустя
простой: проще
порой: порой
непредназначенный: непредназначенное
просьба: просьбой
чтобы: чтобы
пребывание: пребывание
рацион: рацион
здесь: здесь
без: без
необходимость: необходимости
дома: дома
перевозить: перевозить
до: до
комбинезон: комбинезон
помнить: помнить
положить: положить
альтернатива: альтернатива альтернативу
ежедневный: ежедневными
мытье: мытья
мелкий: мелких
адрес: адрес
другой: другой других
отпугивать: отпугивают отпугивающим
ее: ее
отдать: отдать
исследовать: исследовать
собственный: собственное
телефон: телефона
тканевый: тканевые
пригодиться: пригодятся пригодиться пригодится
регулярно: регулярно
сухой: сухого сухой
посол: после
защищать: защищают
лежак: лежак
пищать: пищащих
причина: причинам
понижение: понижения
достать: достаньте
кроме: кроме
же: же
дно: дно
целостность: целостность
обновить: обновить
что: что
светлый: светлых
длительный: длительная
за: за
тип: типу
гигиенический: гигиенические
паразит: паразитов
удовольствие: удовольствием
форма: форме
вычесать: вычесать
силиконовый: силиконовые
дом: доме
ожидать: ожидают
бутылочка: бутылочку бутылочка
лакомство: лакомств лакомства
набор: набором
процедура: процедурой процедурами процедуры
если: если
хозяин: хозяина
повод: повод
любой: любой
захотеть: захочет
из: из
наш: наш нашей
ходить: ходить
ветеринарный: ветеринарному ветеринарным ветеринарный
серьезный: серьезные
удобный: удобнее
их: их
аптечка: аптечку аптечка
многие: многие
контакт: контактов
заказ: заказ
похвалить: похвалить
игрушка: игрушку игрушка игрушки
дождаться: дождаться
сделать: сделать
квартира: квартиры
дорожный: дорожные
смешивать: смешивать
нанести: нанести
транспортировка: транспортировке
загородный: загородной загородных загородном загородные
влажный: влажные влажный
прочий: прочих
испытывать: испытывают
защитить: защитите защитить
нюанс: нюансы
избавить: избавит
обратиться: обратитесь обратиться
собака: собак собаки собаке
упаковка: упаковок
резкий: резкий
безопасность: безопасность безопасности
который: которые которое который котором которых
поэтому: поэтому
крупный: крупной крупных
любимец: любимцу любимец любимца любимце
драть: драть
подобрать: подобрать
ли: ли
привести: привести
тщательный: тщательной
выбрать: выбрать
случай: случаях случай
инструмент: инструментов инструменты
температура: температур
путешествовать: путешествовать
такой: таким такие такая
деть: дело
ощущение: ощущения
текстильный: текстильным
нужный: нужен
несколько: несколько нескольких
питомец: питомцем питомец питомцы питомца питомцу
предпочитать: предпочитает предпочитают предпочитаете
ремень: ремня ремень ремни
мы: нам мы
летний: летние
на: на
рыться: рыться
совершенно: совершенно
водный: водные
свежий: свежем
тот: то
комплект: комплект
не: не
выбор: выборе выбор
использовать: используя используете
указать: укажет укажите
миска: миски мисок
содержать: содержат содержащий
но: но
почта: почту
привычный: привычным привычного
выпускаться: выпускаются
вызвать: вызвать
внешний: внешних
длить: для
карабин: карабин
обрабатывать: обрабатывали обрабатываете
начинать: начинают начинать
количество: количество
туалет: туалет туалета
модель: моделям модели
об: об
понадобиться: понадобятся понадобится
он: он него
даже: даже
от: от
блоха: блохами блох
как: как
все: все
препарат: препараты
возможность: возможность
оснастить: оснащенную
по: по
непромокаемый: непромокаемый
осмотреть: осмотрите
занимать: занимают
огромный: огромное
информация: информацию
подготовить: подготовить
опасный: опасными
риск: риск
одежда: одежду одежда
подбираться: подбираются
способ: способ
высокий: высокого высоких
наличие: наличие наличии
аксессуар: аксессуара
произойти: произойти
проверить: проверьте
переносок: переноску переноски переноске переноска
заранее: заранее
переть: при
