вредный: вреден вредным
приводить: приводят
аккуратный: аккуратного
тоже: тоже
патология: патология
образ: образ
есть: есть
вести: вести
промышленный: промышленных
несбалансированный: несбалансированное
рот: рта
лишний: лишний
косточка: косточки
физический: физическую
мочь: могут может можете
этот: этой этот
пить: пьет
со: со
менее: менее
важный: важно
касаться: касается
уверить: уверены
зубок: зубки
друг: друзей
веточка: веточки веточек
предложить: предложить
помощь: помощью помощь
нести: несет
вырастать: вырастают
сбор: сбор
а: а
дополнительно: дополнительно
производство: производство
в: в
палочка: палочки палочек
птичка: птички птичке
и: и
стачивание: стачивания стачиванию
к: к
известный: известных
сушеный: сушеные
можно: можно
о: о
ухудшение: ухудшение
с: с
у: у
нехватка: нехватка
камень: камень камня
подкормка: подкормки
использоваться: используются
дополнительный: дополнительные дополнительными
производитель: производители
они: они
пищевой: пищевому
отрастать: отрастает
пернатый: пернатый
владелец: владельцы
природа: природе
вариант: вариант
стремиться: стремясь
снижение: снижение
угощенье: угощений
того: того
цвет: цвет
вы: вы вас
оставить: оставьте
необходимый: необходимую
весьма: весьма
необходимо: необходимо
специалист: специалисты
кормить: кормить
планировать: планирует
небольшой: небольшой
слишком: слишком
употребление: употребление
оболочка: оболочки
создавать: создает
химический: химическое
насторожить: насторожить
порой: порой
внутренний: внутренними
свой: свою своей
обычно: обычно
пробовать: пробовать
очистить: очистить
сильный: сильно
проблема: проблемой проблемам
свое: своих
покрывать: покрывает
травмированный: травмированные
популярный: популярные
чтобы: чтобы
также: также
рацион: рационе рацион
чистый: чистый чистом
появиться: появится
дикий: диких дикой
получение: получения
следовать: следует
рождение: рождения
до: до
предварительно: предварительно
сложный: сложное
особенность: особенности
употреблять: употребляя употребляет
ежедневный: ежедневное
находиться: находятся
адрес: адрес
другой: другими
вводить: вводить
клетка: клетке
вовремя: вовремя
отсутствие: отсутствие
доставаться: достается
подвесить: подвесить
однако: однако
слой: слой
питание: питание
сухой: сухие сухих
настороженно: настороженно
резцовый: резцов
зерновой: зерновой зерновые зерновых
число: числе
далекий: подальше
причина: причинами причине
повредить: повредить
рекомендовать: рекомендуем
отзыв: отзыв
же: же
грызун: грызунов грызуну грызуна грызунам
нормальный: нормальную
оценка: оценки
всегда: всегда
иметь: имеет имеющий
снизить: снизить
резец: резцы
грызть: грызет
что: что
фрукт: фрукты
четкий: четко
зуб: зубы зубов
отдавать: отдавать
богатый: богатого
контролировать: контролируют
за: за
оценить: оцените
домашние: домашним
неправильный: неправильное
оказать: оказанная
последний: последних
грибковый: грибковые
приобретаться: приобретается
ожидать: ожидают
активность: активность
часто: часто
момент: момент
некоторые: некоторые
лакомство: лакомствам лакомства
помочь: помочь поможет
труд: трудом
бренд: бренды
справляться: справляются справляется
если: если
добраться: добраться
природный: природного
процесс: процесса процесс
желательно: желательно
подвести: подведем
основа: основу
обновляться: обновляясь
делать: делает делать
ветеринарный: ветеринарному ветеринарного ветеринарную
недобросовестный: недобросовестные
нарушить: нарушить
их: их
бактериальный: бактериальная
многие: многих многие
компонент: компонент
насекомое: насекомых
когда-нибудь: когда-нибудь
качество: качества качестве
заказ: заказ
меню: меню
деревянный: деревянные
покупка: покупка
крыса: крысы
вследствие: вследствие
подойти: подойти
зерно: зерна
становиться: становится
следить: следить следят
подвешиваться: подвешиваются
неудобно: неудобно
около: около
добавлять: добавлять
тщательно: тщательно
различный: различные различными
выглядеть: выглядит
особенно: особенно
здоровье: здоровье
обращать: обращать
должен: должны
белый: белый
роговой: роговой
являться: являются
бывать: бывает
животное: животным
распространить: распространенное
мешать: мешает
чистить: чистит
машина: машин
обратиться: обратитесь обратиться
хотеть: хотим
чрезмерный: чрезмерно чрезмерного
стать: стало
манипуляция: манипуляцию
нужно: нужно
минеральный: минеральных минеральный минеральным
прекрасно: прекрасно
который: которые который которое
поэтому: поэтому
чистота: чистоту
участок: участок
приобретать: приобретать
отрастание: отрастания отрастание
любимец: любимцам любимцу любимца любимцев
провести: проведут
следующий: следующие
семя: семена
это: это этого
клюв: клюв клюва
поддерживать: поддерживать
привести: привести
скрип: скрип
обнаружить: обнаружить
дефицит: дефицит
вместо: вместо
вполне: вполне
случай: случае
чесоточный: чесоточный
справиться: справиться
его: его
такой: такой таких
удалять: удалять
только: только
заложить: заложено
жить: живущие
жизнь: жизни
сантиметр: см
средний: среднем
питомец: питомец питомцу
место: местах места
твердый: твердые твердую
оптимальный: оптимальный оптимальное
или: или
решение: решение
никакой: никакой
далеко: далеко
натуральный: натурального натуральный
относиться: относятся
отрасти: отросшими отросли отросший
включать: включало
мы: мы
экологически: экологически
слизистая: слизистые
действительно: действительно
на: на
состав: составе
тот: том то
не: не
выбор: выбору
самостоятельно: самостоятельно
почему: почему
передний: передние передними
сложно: сложно
указать: укажите
расти: растут
удивление: удивлением
патологический: патологические
хороший: лучше
заготавливать: заготавливают
но: но
почта: почту
стачивать: стачивает
перегрызать: перегрызать
полезно: полезно
привычный: привычный
вызвать: вызовет
когда: когда
внешний: внешнего
длить: для
фосфор: фосфором
нарушение: нарушения
орган: органу
чего: чего
зверек: зверек зверька
вещество: веществ
он: ему он
предлагать: предлагают
норма: норма
от: от
итог: итоги
птица: птиц птицы
мед: меду
появляться: появляется
длинный: длинные длинный
тогда: тогда
способствовать: способствуют
поскольку: поскольку
как: как
сталкиваться: сталкиваются
внимание: внимание
паразитарный: паразитарные
бетон: бетон
ваш: ваш вашего вашей
помогать: помогать
именно: именно
так: так
мнение: мнение
иногда: иногда
по: по
рекомендация: рекомендации
ответственно: ответственно
пернатое: пернатых пернатому пернатым
печальный: печальным
ведь: ведь
занимать: занимает
где: где
основание: основании
врожденный: врожденные врожденная
полость: полости
постоянно: постоянно
предпочтение: предпочтение
риск: риск
светло-серый: светло-серый
костный: костную
очень: очень
самый: самый
способ: способ
материал: материалы материал
кролик: кроликов кролику кролика
товар: товар
наличие: наличии
выбирать: выбирать
быть: было быть
проверить: проверенных
прут: прутьям
источник: источниками
