состоять: состоят
определение: определения
дачный: дачном дачного
специальный: специальным
есть: есть
найти: найти
зимний: зимними
служить: служит
пластик: пластика
установить: установить установите
еще: еще
повлиять: повлиять
непременно: непременно
любить: любят любимую
ряд: рядом
косточка: косточку
обзор: обзор
мочь: могут может мог
этот: эту
стираться: стирается стираются
объем: объема
важный: важно важен
древесина: древесины
изготавливать: изготавливают
множество: множество
встретить: встретить
человек: людей
а: а
прибавить: прибавить прибавьте
дополнительно: дополнительно
в: в
соответствовать: соответствует
и: и
водонепроницаемый: водонепроницаемую
стекловатый: стекловата
к: к
можно: можно
о: о
дать: данным
конструкция: конструкцию конструкциях
она: неё нее она ней
с: с
у: у
завестись: завестись
неспешно: неспешно
определить: определенные
обходить: обходит
элемент: элементом
подстилка: подстилки
смочь: сможет
они: них они
дополнительный: дополнительным
домик: домик
земля: земле
владелец: владельцы
готовый: готовых готовые
мансарда: мансардой
влажность: влажности
ветер: ветра
вверить: вверенную
того: того
вы: вы
оставить: оставьте
изменчивость: изменчивости
необходимый: необходим
проводить: проводят
солнечный: солнечном
необходимо: необходимо
сток: стока
расположить: расположите
дерево: дерева
небольшой: небольшой небольшим
слишком: слишком
время: время
узнать: узнаете
рыть: рыть
интернет: интернете
отнять: отнимите
понаблюдать: понаблюдайте
представление: представлении
свое: своих
соответствующий: соответствующие
куда: куда
тем: тем
популярный: популярным
чтобы: чтобы
также: также
да: да
вблизи: вблизи
чистый: чистый чистые
появиться: появится
получение: получения
прежде: прежде
соблюсти: соблюсти
матрас: матрас матрасы
правильно: правильно
до: до
легко: легко
трава: травы
декоративный: декоративной декоративным
помнить: помнить
экономить: экономит
положить: положить
представитель: представителя представителю
северный: северной
территория: территорию
находиться: находится
мелкий: мелких мелкой
адрес: адрес
собачий: собачьих
представить: представлено
другой: другие других
начать: начнете
света: света
комфортно: комфортно
порыв: порывами
растянуться: растянуться
вздремнуть: вздремнуть
ожидание: ожидании
ее: ее
климатический: климатических
древесный: древесную
пригодиться: пригодится
однако: однако
сметь: смеет
пока: пока
сухой: сухой
защищать: защищает
вход: вход
предназначить: предназначенными предназначена
система: система системы
украшение: украшения
параметр: параметров
срубить: срублен
контроль: контроль
сквозняк: сквозняков
рекомендовать: рекомендуют рекомендуем
отзыв: отзыв
потребность: потребность
вид: виде виды
же: же
стружка: стружку
тамбур: тамбура тамбур
открываться: открывалась открывающаяся
приятный: приятное
пластиковый: пластиковые
оценка: оценки
охранник: охранник
деликатный: деликатном
обязательно: обязательно
иметь: имеет иметь имеют
полностью: полностью
служебный: служебной
нос: носа
что: что
тип: тип
за: за
оценить: оцените
лишь: лишь
тень: тень
форма: форм
ожидать: ожидают
крыша: крыши крыша крыше
зачем: зачем
пространство: пространством
некоторые: некоторые
применяться: применяются
лаять: лает
бренд: бренда
если: если
существовать: существует
современный: современные
своеобразный: своеобразным
природный: природных
процесс: процесс
желательно: желательно
подвести: подведем
из: из
что-либо: что-либо
изоляция: изоляции
способный: способны
уборка: уборки
изделие: изделия
мировой: мировых
наш: наши
обработать: обработана
удобный: удобные
их: их
комфортный: комфортной
очищать: очищать
хвост: хвоста
разобрать: разобранном
качество: качестве качество
пострадать: пострадали
заказ: заказ
деревянный: деревянные
подойти: подойдет
ножка: ножки
лютый: лютые
настолько: настолько
дверца: дверца
большой: большое
испытывать: испытывая
должен: должен
разный: разных
замер: замеры
являться: является
стоять: стоять
собака: собаки собака собак собакам собаке
стать: станет
минеральный: минеральная
грозно: грозно
который: которые который которая
поэтому: поэтому
отличный: отличным
холка: холке
кончик: кончика
участок: участке
крупный: крупных
приезжать: приезжает приезжают
расстояние: расстоянию
любимец: любимец любимцев любимца
провести: провести
это: это этого
большинство: большинства большинство
располагать: располагайте
подобрать: подберете подобрать
рост: росту
изучать: изучать
два: два
удобство: удобства удобство
частный: частной
процент: процент
дрессировка: дрессировки
вполне: вполне
такой: такой такая
его: его
удачный: удачным
жить: живущей живут живёт
только: только
текстильный: текстильную
наклонный: наклонная
алюминиевый: алюминиевым
конура: конура конуре конуру конуры
облегчить: облегчит
надежный: надёжной
несколько: несколько
питомец: питомца питомцев
средний: средних
функция: функцию
место: местом место места
утеплитель: утеплителя утеплитель
изготовление: изготовления
оптимальный: оптимальный
или: или
заветный: заветную
отдых: отдыха
мы: мы
экологически: экологически
устойчивость: устойчивости
разрешение: разрешения
на: на
теплый: тепло
защита: защитой
состав: составом
тот: то
не: не
выбор: выборе выбор
использовать: использовать
самостоятельно: самостоятельно
указать: укажите
отбрасывать: отбрасывающего
спокойный: спокойно
утеплить: утеплить
маленький: мало
но: но
почта: почту
грудь: груди
баланс: баланс
когда: когда
рассчитать: рассчитанные рассчитать
длить: для
разместить: разместить
количество: количество
модель: модели моделей
понадобиться: понадобится
опилка: опилок
он: него он
дополнение: дополнением
даже: даже
от: от
итог: итоги
приобрести: приобрести
спальный: спального спальном
значение: значение
ширина: ширины
открыть: открытом
выполнить: выполнит
попробовать: попробуйте
поскольку: поскольку
произвести: произвести
уютный: уютно
как: как
размер: размер размеры размеру
все: всё все
высота: высоты
условие: условие
именно: именно
ваш: вашему вашей ваш
возможность: возможность
главное: главное
отвечать: отвечающей
иногда: иногда
по: по
четвероногий: четвероногий четвероногого четвероногих четвероногому
ведь: ведь
где: где
безопасный: безопасный
основание: основания
вентиляция: вентиляции
кто: кто
огромный: огромном
уникальный: уникальные
информация: информацию
будка: будка будки будку будок
постараться: постарайтесь
зайти: зайти
съемный: съемный
постоянно: постоянно
продаваться: продается
подушка: подушку
видеть: видеть
самый: самые самым
очень: очень
способ: способ
материал: материалов материалом материал
товар: товар
наличие: наличии
грядка: грядки
быть: быть будет была было
послужить: послужит
переть: при
шерсть: шерсть
