специальный: специального
новый: нового
таблетка: таблетки таблеток
образ: образ
назначение: назначения
есть: есть
разработка: разработка
еще: еще
прогулка: прогулках
любить: любимого
услать: ушли
аптека: аптеках
лапа: лапы
подцепить: подцепить
мочь: может можете могут
эффективный: эффективным эффективные эффективное эффективный эффективной эффективны
нелицензированный: нелицензированных
этот: этих эти
центр: центра
четыре: четыре
важный: важная важно
касаться: касается
под: под
изготавливать: изготавливают
выделять: выделяют
помощь: помощью
тута: тут
а: а
вообще: вообще
сохранить: сохранить
в: в
подробный: подробнее
гельминт: гельминтов
кошка: кошек кошку кошке
и: и
к: к
можно: можно
применение: применение применении
о: о
иностранный: иностранные
подходить: подходящего
с: с
средство: средствами средством средства средство средств
у: у
действовать: действующим действуют действующие
определить: определенные
течение: течение
клещ: клещей
они: им они
производитель: производителем
дополнительный: дополнительную
сезон: сезон
владелец: владельцы
я: я мне
своевременный: своевременно
оно: оно
природа: природе
вариант: варианты
обращаться: обращаются
уже: уже
пройти: пройдите
того: того
вы: вы вас вам
оставить: оставьте
доказать: доказавшие
теперь: теперь
российский: российского российском российской
бояться: бойтесь
проводить: проводить проводите
исчезнуть: исчезло
рассмотреть: рассмотрим рассмотрите
необходимо: необходимо
опытный: опытные
специалист: специалистом
соблюдать: соблюдая
давно: давно
побочный: побочных
небольшой: небольших
снижать: снижать
тест: тест
лечить: лечащим лечить лечат
распределяться: распределяются
внутренний: внутренних
свой: свою
главный: главный
раздеть: раздела
тем: тем
популярный: популярный
чтобы: чтобы
купание: купания
также: также
противопаразитарный: противопаразитарные противопаразитарных
индивидуальный: индивидуальную
появиться: появится
город: городе
получение: получения
перед: перед
следовать: следуя
комплексный: комплексные комплексного
правильно: правильно
полезный: полезных
альтернатива: альтернативы
адрес: адрес
другой: других
переставать: перестают
отпугивать: отпугивают отпугивая
прийти: прийти
давать: давайте давать дают
зоомагазин: зоомагазине зоомагазинах зоомагазина
дискомфорт: дискомфорт
проконсультироваться: проконсультируйтесь
подбирать: подбирая
регулярно: регулярно
однако: однако
сочетание: сочетания
посол: после
себя: себя
защищать: защищают защищает
период: период
читать: читайте
заказать: заказать
короткий: короткий
отзыв: отзыв
вид: виды видов
же: же
купить: купить
один: одним один
оценка: оценки
всегда: всегда
обязательно: обязательно
иметь: имеют
купать: купать
совет: советов советы
зарекомендовать: зарекомендовали
молекулярный: молекулярную
что: что чем
эксперт: эксперт эксперта
четкий: четко
мера: меры
длительный: длительных
оценить: оцените
обеспокоить: обеспокоенные
домашние: домашних
паразит: паразитов
часть: часть
спектр: спектром
домашний: домашнего
вредоносный: вредоносных
ожидать: ожидают
минута: минут
активность: активности
дорогой: дорогие
инструкция: инструкции
некоторый: некоторое
часто: часто
некоторые: некоторые
помочь: помогут поможет
бесплатно: бесплатно
бренд: бренды бренда
процедура: процедур
если: если
статья: статье
существовать: существуют
частый: частые
промокать: промокать
укус: укусы
заявить: заявленного
комбинироваться: комбинироваться
из: из
заменить: заменить
одновременно: одновременно
наш: нашей наш нашего нашем
ветеринарный: ветеринарного ветеринарных ветеринарную ветеринарный ветеринарным
производить: производят
обработать: обработают
черников: черникова
среди: среди
уйти: ушедших
анатолия: анатолий анатолия
их: их
многие: многие
качество: качестве
через: через
заказ: заказ
серый: серым
воспользоваться: воспользуйтесь
доза: дозах
подойти: подойдут
врач: врач врачу врачом врача
различный: различные различных
инспектор: инспектор
заметить: заметить
особенно: особенно
здоровье: здоровье здоровья
рынок: рынка рынке
заниматься: занимаются
тело: телу
должен: должно должен
разный: разные разных
являться: являться являются
бывать: бывают
животное: животных
обратиться: обратиться
собака: собак собаку собаке
клиника: клинику
эффективность: эффективность эффективности
забота: заботы
ко: ко
одновременный: одновременное
различаться: различаются
продукция: продукцию
ветпрепарат: ветпрепараты
нужно: нужно
обладать: обладают
который: которые которым которая которых
вывод: выводы
поэтому: поэтому
комбинировать: комбинировать
холка: холку
приобретать: приобретать приобретайте
совместный: совместная
любимец: любимцев
следующий: следующих следующие
обработка: обработка обработки обработкой обработку
это: этого этом это
ли: ли
подобрать: подобрать
универсальный: универсальных универсальной
ошейник: ошейник ошейники ошейников
выбрать: выбрать
подбора: подбора
вот: вот
случай: случае
стоить: стоит
такой: такие таких
его: его
только: только
жизнь: жизни
жить: живущих
покупать: покупать
капля: капли капель
несколько: несколько
идентичность: идентичность
надежный: надежные надежных
питомец: питомцев питомца питомцу питомцам
или: или
особенный: особенным
лекарственный: лекарственные
широкий: широким
относиться: относитесь
противопоказание: противопоказаний
мы: нас нам мы
на: на
совершенно: совершенно
защита: защиты
водный: водных
тот: то
не: не
выбор: выбором
разрабатывать: разрабатывающего
каждый: каждый
наиболее: наиболее
указать: укажите
хороший: лучше
комбинирование: комбинирование
но: но
много: более
маленький: меньше
почта: почту
привычный: привычные привычного
советовать: советую
когда: когда
вошь: вшей
профилактика: профилактику
внешний: внешних
учитывать: учитывать
длить: для
обрабатывать: обрабатывать
разбираться: разбираться
чувствительность: чувствительность
действие: действия действие
общий: общего
дождь: дождем
он: он
заразиться: заразиться
означать: означает
состояние: состоянию
даже: даже
от: от
германий: германии
блоха: блох
компания: компании
причинять: причиняя
как: как
статус: статус
внимание: вниманием
все: всех всего всему
препарат: препарата препаратов препараты препарату
глист: глистов
ваш: вашему вашего вашей ваш
против: против
возможность: возможности
по: по
четвероногий: четвероногого четвероногих
рекомендация: рекомендацией
защитный: защитное
ведь: ведь
больший: больше большей
где: где
срок: срок
безопасный: безопасным безопасный
информация: информацией
опасный: опасны
привыкнуть: привыкли
продавец: продавцы продавцов
способ: способ
какой: какими
линейка: линейка
товар: товар
наличие: наличии
быть: быть были будут
переть: при
