релаксация: релаксации
долгий: долгое
специальный: специальной
оснащение: оснащение
новый: новому новым новая
день: дня
металл: металла
образ: образ
еще: еще
непременно: непременно
любить: любимую любят
любимица: любимицы любимица любимице любимицей
со: со
важный: важная
под: под
нести: несет
пол: пол
жертва: жертвами
а: а
дополнительно: дополнительно
передвигать: передвигать
в: в
и: и
охотничий: охотничьи
водонепроницаемый: водонепроницаемую
живой: живому
помещаться: помещается
к: к
сушеный: сушеного
о: о
коллекция: коллекциях
с: с
она: она ей
положительный: положительные
у: у
дополнительный: дополнительный дополнительное
они: они них им
домик: домики домик
владелец: владельцу владельцы владельцам
собрать: соберите
вариант: варианты
спить: спит
необходимый: необходимый необходима
развлечь: развлечет
употребление: употребление
классический: классических
небольшой: небольших
время: время
непригодный: непригодна
забыть: забыть
любоваться: любуйтесь
веселый: веселых
готовить: готовим
подарок: подарки подарок
кошечка: кошечка кошечку
составлять: составляющая
порадовать: порадуют порадуйте
также: также
звездочка: звездочкой
член: члены
появиться: появится
получение: получения
оставлять: оставлять
понравиться: понравится понравятся
легко: легко
прием: приема
трава: травы
находиться: находиться
незабываемый: незабываемую
комфортно: комфортно
обожать: обожают
задача: задача
себя: себя
короткошерстный: короткошерстных
предназначить: предназначены
укромный: укромных
угощение: угощения
случайно: случайно
сквозняк: сквозняк сквозняка
рекомендовать: рекомендуем
продумывать: продумываем
отзыв: отзыв
хищник: хищнике
приятный: приятная
пластиковый: пластиковые
один: одна
оценка: оценки
обязательно: обязательно
иметь: имеют иметь
совет: совет
оценить: оценит оцените
нередкий: нередки
часть: часть
тренировать: тренируют
сумка: сумок
колокольчик: колокольчики
крепиться: крепятся крепится
часто: часто
подарочный: подарочных
некоторые: некоторых
помочь: помогут поможет
бренд: брендов бренда
пробудить: пробудит
добраться: доберется
природный: природная
тортик: тортик
комфортный: комфортной
шея: шее
становиться: становится становятся
перепад: перепадов
прочить: прочь
доставлять: доставляя
опыт: опытом
влиять: влияют
поучаствовать: поучаствовать
удивить: удивит
должен: должна должны
поставить: поставить
праздничный: праздничное праздничный
разогрев: разогрева
новогодний: новогодним новогодней
животное: животное
временить: времени
навык: навыки
гарантированный: гарантированно
бубенчик: бубенчики
зона: зона
подготовка: подготовка
салфетка: салфетку
достаточно: достаточно
устроить: устроить
стать: станет
струиться: струится
отличный: отличный
вызывать: вызывают
металлический: металлические металлическая
это: это этом
прочный: прочные
холодное: холодного
вкус: вкусами
еда: еды
украшать: украшаем
непрерывно: непрерывно
размерить: размеренным
только: только
дизайнерский: дизайнерскими
менять: меняйте
функция: функцией
норка: норки
или: или
потому: потому
возраст: возраст
диван: диван
резервуар: резервуар
теплый: теплые теплой теплый
уход: уходу уход ухода
спокойный: спокойно
хороший: лучше
свитер: свитер
много: много
регулировать: регулировать
сообразительность: сообразительность
добавить: добавлены
стачивать: стачивать
прятаться: прятаться
когда: когда
играть: играть
учитывать: учитывайте
почувствовать: почувствовать
автопоилка: автопоилки
подарить: подарите
красавица: красавица
забавный: забавные
говядина: говядины
отдохнуть: отдохнуть
приобрести: приобрести
выполнить: выполненных
мягкий: мягкого мягкий
отдыхать: отдыхать
уютный: уютные уютным
ориентироваться: ориентируясь
лапка: лапок
размер: размер
симпатичный: симпатичный
попросту: попросту
вяленый: вяленого
против: против
умудрить: умудренная
ваш: вашего вашей ваш
больший: больше большую
кто: кто
полость: полостью
активный: активной
самый: самых
подаваться: подается
товар: товар
выбирать: выбирайте
лабиринт: лабиринты
быть: будет будут быть было
приодеть: приодеть
хлопоты: хлопотах
успокоительный: успокоительное
приятно: приятно
заодно: заодно
долговечный: долговечны
мочь: могут может
этот: этих эта этот
шуршать: шуршащие
дразнилка: дразнилку дразнилка
разнообразный: разнообразными разнообразные
стрижка: стрижки
издавать: издают
кошка: кошки кошка кошку кошкам кошек
известный: известные
можно: можно
занятой: занятых
темперамент: темперамент
действовать: действующие
мыться: моется
позволить: позволит
во: во
ассоциироваться: ассоциируется
кошачий: кошачья кошачьих кошачьего
готовый: готовых готовые
интерактивный: интерактивной
вы: вас
оставить: оставьте
волна: волны
проводить: проводить проводит
необходимо: необходимо
побаловать: побаловать
свое: свои своего своим
чтобы: чтобы
здесь: здесь
осуществлять: осуществлять
до: до
полезный: полезную полезных
мясной: мясного
особенность: особенность
адрес: адрес
представить: представлены представлен
чистка: чистки
работа: работы
весить: весь
трек: треки
побуждать: побуждает
эмоция: эмоции
ее: ее
пожилой: пожилые пожилая
пока: пока
посол: после
защищать: защищающий
лежак: лежак
накапливать: накапливать
причина: причиной
вид: виде
весело: весело
деликатный: деликатном
керамический: керамические керамическая
что: что чем
положение: положение
посуда: посуда
стильный: стильный
за: за
предмет: предметы
домашние: домашних
лосьон: лосьоны
ожидать: ожидают
рукавица: рукавицы
лакомство: лакомства лакомствами
гамак: гамаки
изготавливаться: изготавливаются изготавливается
набор: набор наборы
если: если
развить: развить
хозяин: хозяева
живительный: живительная
любой: любой
украсить: украсить
ассортимент: ассортимент ассортименте
отличаться: отличающиеся
пушистый: пушистых пушистая пушистого
оригинальный: оригинальную
из: из
изделие: изделием
галстук: галстук
наш: наших наш
подставка: подставку
удобный: удобный
их: их
мясо: мяса
бактериальный: бактериальный
многие: многие
пострадать: пострадает
клетчатый: клетчатый
заказ: заказ
исключительно: исключительно
шарик: шарики
игрушка: игрушка игрушки
следить: следить
коготок: коготки
аппетитный: аппетитных
сделать: сделать
тоннель: тоннели
здоровье: здоровье здоровья
испытывать: испытывая
год: году год
жидкость: жидкости
спасти: спасти
приходиться: приходится
который: которые который котором которых которая которому
аромат: ароматами ароматы
поэтому: поэтому
обои: обои
автокормушка: автокормушки
например: например
располагать: располагающие
привести: приведут
выбрать: выбрать
хорошо: хорошо
перевернуть: перевернет
создать: создаст создать
такой: такого такое
одиночество: одиночестве
подвесной: подвесной
правильный: правильной
вод: вода
нужный: нужное
несколько: несколько
место: место
предпочитать: предпочитают
никакой: никаких
проспать: проспать
душ: душе
натуральный: натуральной натуральное натуральные натуральных
местечко: местечком
широкий: широкий
раздражать: раздражать
включать: включающий
мы: мы
паштет: паштета
прекрасный: прекрасный
на: на
состав: составы
тот: тех
комплекс: комплекс
глаз: глаз
стирка: стирки
не: не
выбор: выборе выбор
самостоятельно: самостоятельно
каждый: каждая каждому каждую
ни: ни
указать: укажите
миска: миски миску миска
утеплить: утепленный
дарить: дарил
маленький: маленький маленьком
но: но
почта: почту
ну: ну
идеальный: идеальный идеальное
длить: для
незаменимый: незаменимый
модель: модели модель
развитие: развития
он: него ему
семья: семьи
даже: даже
от: от
сфинкс: сфинксов
способствовать: способствует
сон: сна
как: как
условие: условиях
возможность: возможность
отсутствовать: отсутствует
оснастить: оснащена
по: по
безопасный: безопасны
впитывать: впитывает
подготовить: подготовили
угловой: угловой
одежда: одежда
ножнички: ножнички
скорый: скорее
порода: пород
способ: способ
забывать: забывают
наличие: наличием наличии
аксессуар: аксессуары аксессуар
яркий: яркие яркими
мех: мехом
пониженный: пониженный
переносок: переноске переноски
источник: источник
переть: при
