приводить: приводит
производить: производит
среди: среди
таблетка: таблетки таблеток
есть: есть
их: их
еще: еще
преимущество: преимуществ
через: через
заказ: заказ
мочь: могут можете
эффективный: эффективно эффективен
этот: этой эти
со: со
сам: сам
борьба: борьбе
съесть: съест
множество: множество
рынок: рынке
нервно-мышечный: нервно-мышечных
а: а
разный: разные
совмещать: совмещать
в: в
белков: белков
подробный: подробнее
и: и
животное: животного
к: к
защитить: защитить
чей: чья
применение: применением применения
можно: можно
о: о
собака: собак
дать: дать
упаковка: упаковке
с: с
средство: средства
международный: международными
действовать: действовать действующее действует действуют
у: у
передаваться: передаются
течение: течение
достаточно: достаточно
обладать: обладают
они: они ими них
производитель: производителей
клещ: клещей
который: которые
вывод: выводы
поэтому: поэтому
уже: уже
крупный: крупных крупнейших
искупать: искупать
важность: важность
вызывать: вызывают
раз: раз
провести: провести
вы: вы
это: это
большинство: большинством
оставить: оставьте
вкус: вкусом
уничтожать: уничтожает
цель: целях
расположить: расположена
отложить: отложить
рассказать: расскажем
вполне: вполне
про: про
его: его
такой: таких
хватить: хватит
свой: своей
вместе: вместе
только: только
рассказывать: рассказывали
плановый: плановой
капля: каплями
чтобы: чтобы
также: также
питомец: питомца питомец
средний: средних
противопаразитарный: противопаразитарной
появиться: появится
функция: функцию
место: места
получение: получения
снизиться: снизится
или: или
американский: американская
легко: легко
до: до
удобно: удобно
возраст: возрастов
включать: включая
мы: мы
особенность: особенности
на: на
состав: составе
адрес: адрес
представить: представлено
успевать: успевают
другой: другими
соответствие: соответствии
не: не
использовать: использовать
ванный: ванны
указать: укажите
содержать: содержат
давать: давать
спокойный: спокойно
но: но
много: много
почта: почту
выпускаться: выпускаются
задача: задачей
когда: когда
штаб-квартира: штаб-квартира
профилактика: профилактики профилактике
играть: играть
длить: для
посол: после
гибель: гибели гибель
начинать: начинают
часы: часов
составить: составит
действие: действие
полчаса: полчаса
чего: чего
изготовитель: изготовитель
рекомендовать: рекомендуем
нисколько: нисколько
разрешить: разрешено
отзыв: отзыв
вещество: вещество
вид: видов
производиться: производятся
он: он
заразиться: заразиться
даже: даже
от: от
один: одной одна
оценка: оценки
купать: купать
способствовать: способствуют
блоха: блох
компания: компания компаний
подавлять: подавляет
что: что
произвести: произведены
тушеный: тушеной
как: как
фармакологический: фармакологических
все: всех всеми
препарат: препарата препаратов
оценить: оцените
против: против
ваш: вашей ваш
паразит: паразитов
так: так
удовольствие: удовольствием
по: по
разов: разовой
форма: формами
передавать: передаваемых
ожидать: ожидают
ведь: ведь
кислота: кислоты
обезопасить: обезопасите
опасный: опасных
использование: использования
труд: труда
синапс: синапсах
справляться: справляться справляются
способ: способ
товар: товар
наличие: наличии
рецептор: рецептора
принятие: принятия
быть: будут
из: из
