поездка: поездке поездки поездку
придумать: придумать
нервничать: нервничает
вести: вести ведет
установить: установите
еще: еще
ряд: рядом
любить: любимое любимую любимого
мочь: может можете могла
любимица: любимицу любимица любимице любимицы
этот: этот
сам: самое
мышка: мышку
важный: важно важный
замок: замок
полный: полный
стирать: стирать
предложить: предложить
а: а
в: в
немного: немного
кошка: кошек кошка кошки кошкам кошке кошку
одеяло: одеяло
и: и
к: к
времяпрепровождение: времяпрепровождение
можно: можно
применение: применении
дать: данной
с: с
она: ней нее она
средство: средства
у: у
элемент: элементами
смочь: сможет
дополнительный: дополнительными
они: них
владелец: владельцы
вариант: вариант
обеспечить: обеспечить обеспечит
того: того
вы: вы вам вами
свободно: свободно
оставить: оставьте
теперь: теперь
одноразовый: одноразовую одноразовые
бояться: боятся
проводить: проводить
отвлечь: отвлечет
расположить: расположите
необходимо: необходимо
кормить: кормить
просто: просто
слишком: слишком
планировать: планировать
употребление: употребление
чувствовать: чувствовала
время: время
спать: спать
очищение: очищения
погладить: погладить
просьба: просьбой
куда-то: куда-то
ненадолго: ненадолго
чтобы: чтобы
также: также
здесь: здесь
корма: корма
появиться: появится
отвлекать: отвлекать
получение: получения
прежде: прежде
плед: плед
комфорт: комфортом
следовать: следует
легко: легко
слегка: слегка
трава: трав
положить: положить
находиться: находясь
адрес: адрес
другой: других
вред: вреда
комфортно: комфортно
давать: давайте
надо: надо
ее: ее
лоток: лоток
отдать: отдать
задача: задача
тканевый: тканевую
пригодиться: пригодиться
залезть: залезть
однако: однако
почистить: почистите
закрыть: закрыть
себя: себя собой
складываться: складывается
пищать: пищащими
система: систему
рекомендовать: рекомендует рекомендуем
отзыв: отзыв
достать: достал
кроме: кроме
же: же
успокаивать: успокаивающий успокаивающее
приятный: приятные
дно: дно
пластиковый: пластиковую
один: один одна
нормальный: нормальная
складный: складные
оценка: оценки
всегда: всегда
обязательно: обязательно
деликатный: деликатном
иметь: иметь имела имел имеет
заводной: заводную
что: что
просунуть: просунуть
неподдельный: неподдельный
за: за
предмет: предмет
оценить: оцените
домашние: домашних
силиконовый: силиконовые
ожидать: ожидают
минута: минут
бутылочка: бутылочку
повернуть: повернуть
момент: моментов момент
часто: часто
лакомство: лакомство
некоторые: некоторые некоторым
изготавливаться: изготавливаются
несмотря: несмотря
беспокойно: беспокойно
если: если
статья: статье
окошко: окошко
курс: курс
любой: любой
желательно: желательно
подвести: подведем
основа: основе
запустить: запустить
из: из
делать: делать
наш: наших
негативный: негативных негативные
обернуться: обернуться
ветеринарный: ветеринарную ветеринарному
удобный: удобной
аптечка: аптечку
многие: многие
накопительный: накопительный
через: через
заказ: заказ
внутрь: внутрь
игрушка: игрушку
приучить: приучить
врач: врачу
сделать: сделать
дверца: дверцу
связанный: связаны
прилечь: прилечь
здоровье: здоровью
закрытый: закрытой
нанести: нанесут
обращать: обращайте
влажный: влажной влажные
должен: должна
животное: животных
обратиться: обратитесь
упаковка: упаковку
предстоять: предстоят
салфетка: салфетки
досталь: достали
непривычный: непривычный
стать: стала
безопасность: безопасность
который: которое которой которые который
поэтому: поэтому
вызывать: вызывает
порция: порцию
это: это
большинство: большинства большинство
ограничивать: ограничивает
подобрать: подобрать подберет
привести: привести
встать: встать
кинуть: кинуть
выбрать: выбрать выбранный
прочность: прочность
вполне: вполне
взять: возьмите взять
дальний: дальние
его: его
такой: такие
деть: дело
только: только
правильный: правильном
храниться: хранится
несколько: несколько
привлечь: привлечь
питомец: питомцев питомца питомцу питомец
дорога: дороге
место: места
держать: держите
периодический: периодически
пеленка: пеленку
или: или
далеко: далеко
относиться: относилась
лежать: лежать
мы: мы
чаща: чаще
на: на
совершенно: совершенно
не: не
выбор: выбор
самостоятельно: самостоятельно
почему: почему
указать: укажите
спокойный: спокойно
хороший: хорошую
много: много
почта: почту
пыль: пыли
постелить: постелите
привычный: привычном привычный
когда: когда
замкнутый: замкнутое
длить: для
начинать: начинать
модель: модель модели моделям
забавный: забавных
понадобиться: понадобится
дача: дачу
первый: первая
поиграть: поиграть
он: он
желание: желании
от: от
итог: итоги
приобрести: приобрели приобретет
мягкий: мягкий
игра: игр
приоткрыть: приоткрыть
попробовать: попробовать
поскольку: поскольку
как: как
внимание: внимание
все: всего все
ваш: ваша вашей ваш
главное: главное
возможность: возможность
так: так
там: там
четвероногий: четвероногого
протереть: протрите
занимать: занимает
выпускать: выпускать
принять: принятые
гараж: гараже
привыкнуть: привыкла
предпочтение: предпочтение
использование: использованием
видеть: видеть
самый: самым
способ: способ
товар: товар
наличие: наличии
аксессуар: аксессуар аксессуару
выбирать: выбирайте
быть: будет было была быть были
переносок: переноска переноске переноску переноски
переть: при
второй: вторая
