поездка: поездок
водостойкий: водостойкий
специальный: специальные специально
раздражение: раздражения
новый: новому новым новом
день: дней дня
таблетка: таблетки
еще: еще
прогулка: прогулки прогулок
происходить: происходит
любить: любимого
гибнуть: гибнуть
эффективный: эффективны эффективно
менее: менее
важный: важен важно
пойти: пойдет
натирать: натирает
содержимое: содержимое
множество: множество
аллергия: аллергия аллергии
а: а
пусть: пусть
в: в
заболевание: заболевания заболеваний
отломить: отломите
содержание: содержание
и: и
охотничий: охотничьим
полгода: полугода
к: к
подходить: подходящего подходит
плотно: плотно
вероятность: вероятностью вероятность
с: с
она: нее она ей
средство: средства средство
у: у
применять: применять
лекарство: лекарстве лекарств лекарства лекарство
течение: течение
шампунь: шампуни
запах: запах запаха
область: область
они: ними них они ими ним
клещ: клещей клещами
природа: природу
конкретный: конкретной конкретно
возникновение: возникновении
эмульсия: эмульсию
поместить: помещенную
входить: входят
раздвинуть: раздвиньте
слишком: слишком
быстро: быстро
время: время
посоветоваться: посоветуйтесь
про: про
распределяться: распределяется
внутренний: внутренних внутренние внутреннему
простота: простота
сильный: сильно
кошечка: кошечка
раствор: раствор
также: также
индивидуальный: индивидуальная индивидуальной
появиться: появится
отвлекать: отвлекайте
получение: получения
носить: носить
следовать: следуйте
комплексный: комплексные комплексно комплексный
легко: легко
прием: прием
удобно: удобно
написать: написано напишем
лактация: лактации
надевать: надевайте надевать
прийтись: придется
сначала: сначала
комфортно: комфортно
выкинуть: выкиньте
надо: надо
обеспечивать: обеспечивают обеспечивает
подбирать: подбирать
аллергический: аллергическая аллергической аллергическую
себя: собой
пластмассовый: пластмассовый
часы: часов
сколько: сколько
угощение: угощением
скапливаться: скапливаются
рекомендовать: рекомендуем
отзыв: отзыв
выстроиться: выстроиться
постепенно: постепенно
купить: купите
сальный: сальных
оценка: оценки
одевать: одевать
обязательно: обязательно
иметь: имеют
совет: советов
полностью: полностью
научить: научите
блошиный: блошиного
пример: примеры
расчет: расчета
оценить: оцените
хотеться: хочется
минута: минут
инструкция: инструкциях инструкцию
надеть: наденьте
верхний: верхний
некоторые: некоторые некоторых
инфекция: инфекциями
процесс: процесс процесса
заменить: заменить
кожа: кожей кожу коже
курица: курицы
хранить: храните
обработать: обработанного
среди: среди
выдавить: выдавите
комфортный: комфортных
предотвращать: предотвращая
шея: шее
качество: качестве
преимущество: преимущества
выносить: выносят
взрослый: взрослых
дерматит: дерматита
подойти: подойдут подойдет
логический: логическая
приучить: приучить
врач: врача
тюбик: тюбик
обнаружиться: обнаружились обнаружится
должен: должен
заразить: заражен
получать: получает
животное: животное животного животным животных животные
сравнение: сравнению
временить: времени
увеличивать: увеличивая
флакон: флакон
весомый: весом
решать: решает решать
обладать: обладает обладают
выкидывать: выкидывайте
закрепить: закрепить
обучение: обучения
кончик: кончик
немедленно: немедленно
вызывать: вызываемых
провести: провести
отпустить: отпустите
обработка: обработки
это: это этом этого этим
большинство: большинства
гулять: гулять
вкус: вкус
рост: роста
два: двух
ошейник: ошейниках ошейником ошейника ошейник ошейники ошейнике ошейниками ошейнику ошейников
обнаружить: обнаружено
удобство: удобство
разница: разница
сироп: сиропы
обнимать: обнимать
наделить: надели
суспензия: суспензии
его: его
инвазия: инвазии
пустой: пустой
эффект: эффекта эффектом эффектов
красивый: красивую
только: только
сантиметр: см
ветеринар: ветеринару
капля: каплях капель капли
нельзя: нельзя
пипетка: пипетку пипетка пипетки
заражение: заражении заражений заражения
держать: держать
вирус: вирусами
хорек: хорьков
или: или
трогать: трогать
возраст: возраст возраста
лекарственный: лекарственные
защита: защиту защиты
воздействие: воздействие
успевать: успевают
полимерный: полимерных
спот: спот
быстрый: быстрее
хороший: лучше
наносить: наносить
много: много
репеллент: репелленты
когда: когда
цепочка: цепочка
профилактика: профилактики
рассчитать: рассчитана
страдать: страдает
болезный: болезней
ленточный: ленточных
обычный: обычный обычных
затем: затем
действие: действия
равномерно: равномерно
испачкаться: испачкался
поймать: поймать
говядина: говядины
дача: дачу
разрешить: разрешено
вещество: веществ веществам вещества
остановиться: остановиться
масса: массой
выбираться: выбирается
состояние: состояние
всасываться: всасываются
появляться: появляться
игра: играми
компания: компанией
ориентироваться: ориентируйтесь
именно: именно
против: против
ваш: вашему ваш вашего вашей
так: так
старший: старше
французский: французской
четвероногий: четвероногого четвероногий
рекомендация: рекомендациям рекомендаций
ведь: ведь
возникнуть: возникнуть
мыть: мыть
срок: срок
узкий: узкие
привыкнуть: привыкла
зафиксировать: зафиксировать
использование: использовании использования
реакция: реакция реакции реакцию
неделя: недель
освоиться: освоиться
материал: материалов
товар: товар
минус: минусы минусам
выбирать: выбирайте выбирать
охотно: охотно
быть: было будет быть была
шерсть: шерсть
аккуратный: аккуратно
лента: ленты лента
исходить: исходя
есть: есть
пахнуть: пахнуть
представлять: представляет
внимательно: внимательно
разработать: разработаны
лишний: лишний
мочь: могут может
месяц: месяцев
этот: эти этой этих
сам: самих
потомство: потомства
марка: марки
друг: друга друг
тута: тут
вообще: вообще
гельминт: гельминтов
кошка: кошек кошки кошками кошку кошке кошка
прочитать: прочитайте
бы: бы
стресс: стресс
можно: можно
применение: применением
отнести: отнести
дать: дать
почтить: почти
действовать: действующее действует действующих действующим действуют действующие действующий действовать
посидеть: посидите
использоваться: используются
производитель: производителей
во: во
вес: вес веса
уже: уже
извинить: извините
того: того
вы: вы вас вам
остаток: остатки
оставить: оставьте
цель: целях
необходимо: необходимо
побочный: побочных
снижать: снижает
спустя: спустя
существенно: существенно
сутки: суток сутки
лечить: лечащего
щенок: щенков
ветврач: ветврачом
обучить: обучить
соприкасаться: соприкасалась
свое: свои
убедиться: убедитесь убедиться
тем: тем
чтобы: чтобы
потискать: потискать
плавать: плавать
кубик: кубики
перед: перед
дома: дома
шерстить: шерсти
правильно: правильно
между: между
до: до
погибать: погибают
сложный: сложнее
декоративный: декоративного
особенность: особенностях
выступать: выступают
мелкий: мелких
адрес: адрес
другой: других другое другими другие
отпугивать: отпугивают отпугивать
давать: давать
пар: пару
ее: ее
песик: песик
проконсультироваться: проконсультируйтесь
посол: после
профилактический: профилактических профилактическое
период: период периоды
число: числе
знать: знают
причина: причине
беременность: беременности
короткий: короткий
вид: видов виде
производиться: производятся
достать: достаньте
же: же
кроме: кроме
регулятор: регулятор
всегда: всегда
поражение: поражения
купать: купать
свойство: свойства
выдавливать: выдавливайте
снять: снять снимите
что: что
покинуть: покинуть
четкий: четкая
длительный: длительный длительного
за: за
паразит: паразитов паразитами
спектр: спектр спектра
котенок: котят котятам
форма: формах форма форме
ожидать: ожидают
брать: брать
намного: намного
лакомство: лакомствами лакомством лакомство
зависеть: зависит
процедура: процедуру
существовать: существует
статья: статье
если: если
современный: современные
повод: поводу
укусить: укусить
любой: любой
из: из
ограничение: ограничений ограничение
сахарный: сахарные
удобный: удобную удобна
их: их
многие: многие
насекомое: насекомые насекомых насекомыми
контакт: контакте контакт контакта
компонент: компонентов
вязка: вязки
заказ: заказ
доза: доза
оказаться: окажется
фактор: факторы
длинношерстный: длинношерстных длинношерстные
следить: следить
неудобно: неудобно
восторг: восторге
около: около
застежка: застежкой
аппетитный: аппетитный
квартира: квартире
съесть: съедено
заметить: заметили
тело: теле
здоровье: здоровья здоровье
нанести: нанести
нейтрализоваться: нейтрализуется
разный: разных
исключать: исключает
будущее: будущего
кг: кг
распространить: распространенных
обратиться: обратитесь
собака: собак собаки собаку собакам собакой
гладить: гладить гладьте
лечение: лечение лечения
берет: берете
резкий: резкий
круглый: круглых
беременная: беременных
прекрасно: прекрасно
который: которые который которым которыми которое
вывод: выводы
поэтому: поэтому
длительность: длительность
токсичный: токсичен
холка: холку холки холке
заставлять: заставляя заставляйте
например: например
следующий: следующие
привести: приведем
уничтожать: уничтожали
непереносимость: непереносимость непереносимости
выбрать: выберете выбрать
рассказать: расскажем
колтун: колтуны
вот: вот
хорошо: хорошо
случай: случае
сразу: сразу
такой: такого
плюс: плюсы плюсов
ощущение: ощущениям
пломбир: пломбира
несколько: несколько
питомец: питомца питомцу питомцев питомцами питомец
отдельно: отдельно
место: месте
никакой: никаких никакого
проходить: проходить проходит
благодаря: благодаря
широкий: широкого
ровный: ровно
включать: включая
мы: мы
перечислить: перечислим
на: на
приучение: приучения приучение
состав: составе состав
тот: то те том тех
выбор: выборе выбора
не: не
барс: барс
использовать: использовать
наиболее: наиболее
шлейка: шлейку шлейки
указать: укажите
кровь: кровь
содержать: содержат содержит
но: но
почта: почту
неэффективный: неэффективен неэффективны
фиолетовый: фиолетовый
нанесение: нанесения
внешний: внешних внешними
ношение: ношения ношению
длить: для
гибель: гибель
начинать: начинайте начинают
количество: количества
содержаться: содержащимся
модель: модели моделей модель
об: об
орган: органы
нет: нет
интенсивный: интенсивной
он: него он
развитие: развития
даже: даже
от: от
переходить: переходите
противиться: противится
железо: железах
блоха: блохи блох блохами
как: как
первое: первые
внимание: внимание
принимать: принимать
все: все всего всех
препарат: препаратов препараты препарата препарату препарат
глист: глисты глистов
родитель: родителей
условие: условиях
помогать: помогающие
сопровождать: сопровождая
по: по
защитный: защитные
занимать: занимает
огромный: огромная
опасный: опасны
немой: нем
принять: примет
риск: риск
очень: очень
порода: пород породы породу
способ: способ
высокий: высокой
какой: каком
забывать: забывайте
наличие: наличии
аксессуар: аксессуара аксессуару аксессуаре
переть: при
