вывести: выведены
есть: есть
зимний: зимняя зимнюю
еще: еще
прогулка: прогулки
происходить: происходит
позаботиться: позаботилась
мочь: могут можете может
лапа: лапы
этот: этой
со: со
четыре: четыре
касаться: касается
бесплатный: бесплатной
друг: друзей
под: под
прохладный: прохладно
проволочь: проволоки
связаться: свяжитесь
помощь: помощь помощью
тута: тут
дополнительно: дополнительно
а: а
в: в
заболевание: заболевание
иммунитет: иммунитетом
и: и
к: к
можно: можно
о: о
она: она
с: с
у: у
подушечка: подушечек
минимальный: минимальные
стремление: стремление
смочь: сможете
использоваться: используются
знакомый: знакомых
они: они ими
дополнительный: дополнительное
родина: родиной
во: во
природа: природа
уже: уже
сугроб: сугробами
раз: раза
вы: вам вы
магазин: магазинов
аргументировать: аргументируют
гардероб: гардеробе
оставить: оставьте
кусок: куски
необходимый: необходима
необходимо: необходимо
специалист: специалистом
просто: просто
слишком: слишком
время: время
ушко: ушками
миниатюрный: миниатюрных
химический: химические
порой: порой
недавно: недавно
прорезиненный: прорезиненной
сильный: сильные
обморожение: обморожению обморожения
чтобы: чтобы
также: также
появиться: появится
получение: получения
прежде: прежде
услуга: услугой
понравиться: понравившиеся
следовать: следует
предварительно: предварительно
слегка: слегка
поджимать: поджимает
представитель: представителям представители
находиться: находятся находиться
адрес: адрес
симптом: симптомы
воздействовать: воздействуют
комфортно: комфортно
ее: ее
климатический: климатическим
пожилой: пожилые
единодушно: единодушно
телефон: телефону
требоваться: требуется
однако: однако
жалобно: жалобно
заказать: заказав
причина: причине
жаркий: жаркие
отзыв: отзыв
один: одна один
оценка: оценки
одевать: одевать
экзотический: экзотических
доставить: доставьте
снизить: сниженным
что: что
перенести: перенесли
подверженный: подвержены
предмет: предметы
оценить: оцените
домашние: домашних
оказать: оказать
ожидать: ожидают
часто: часто
уязвимый: уязвимые
некоторые: некоторыми некоторым
если: если
обувь: обувь
плюсовой: плюсовые
природный: природную
подвести: подведем
организм: организмы
из: из
способный: способна
кожа: кожу
сводиться: сводится
подстерегать: подстерегают
наш: нашим
ветеринарный: ветеринарную ветеринарные
переохлаждение: переохлаждением
серьезный: серьезную
нарушить: нарушить
их: их
получить: получить
искусственно: искусственно
заказ: заказ
воспользоваться: воспользуйтесь
зимой: зимой
утеплять: утеплять
осколок: осколки
становиться: становится
врач: врачи
особенно: особенно
заметить: заметили
должен: должны
довольный: довольно
опасность: опасность опасности
оплатить: оплатив
являться: являются
посыпать: посыпают
из-за: из-за
год: года
защитить: защитить защитит
собака: собак собаки собака собакам собаками собаку
приходиться: приходилось приходится
достаточно: достаточно
нужно: нужно
который: которым которых которые
инфекционный: инфекционное
нежный: нежную
любимец: любимца
группа: группе
это: это этого
холодное: холодное
гулять: гулять
подобрать: подобрать
обнаружить: обнаружить
два: два
взять: возьмите
стоить: стоит
температура: температуры
его: его
такой: такая
вместе: вместе
примерка: примерку примерки
только: только
нужный: нужна
скользить: скользить
питомец: питомец питомца
улица: улицы улице
дорога: дорогах
место: места
или: или
приспособить: приспособлены
мы: мы
действительно: действительно
чаща: чаще
на: на
состав: составы
защита: защиты
теплый: теплая
тот: то
минимум: минимум
не: не
образоваться: образуется
случаться: случается
ни: ни
указать: укажите
хороший: лучше
утеплить: утепленная утепленной
но: но
много: более
почта: почту
когда: когда
реагент: реагентов реагенты
учитывать: учитывать
длить: для
независимо: независимо
модель: модели
понадобиться: понадобятся
первый: первую
наверняка: наверняка
даже: даже
от: от
итог: итоги
длинный: длинными
утепление: утепление
слышать: слышать
холод: холода
как: как
лапка: лапки
просто-напросто: просто-напросто
все: всего
именно: именно
терморегуляция: терморегуляцию
ваш: вашей ваш
так: так
по: по
иногда: иногда
четвероногий: четвероногим четвероногие четвероногого
больший: больших
травма: травмы
опасный: опасными опасные опасны
риск: риска риск
зима: зимы
одежда: одежда одежду
самый: самые
очень: очень
порода: породы пород породам
способ: способ
какой: какую каким какие
товар: товар
наличие: наличии
признак: признаки
быть: было были быть будет
никак: никак
активно: активно
