новый: новых
день: дней дня
хватать: хватает
поведение: поведении
таблетка: таблеток
еще: еще
прогулка: прогулках
заключаться: заключается заключаются
эффективный: эффективно
воды: воды
делиться: делятся
со: со
апатия: апатия
менее: менее
важный: важна важно
апатичный: апатичным
стирать: стирайте
полный: полного
пол: пол
перчатка: перчатками
а: а
в: в
заболевание: заболевание заболеваний
помещение: помещениях помещения помещение помещений
содержание: содержание
пункт: пунктов
и: и
к: к
подходить: подходящая подходят
о: о
ухудшение: ухудшение
переносчик: переносчиками
с: с
она: она ней
средство: средство средства средством средств средствами
у: у
новорожденная: новорождённых
шампунь: шампуней шампуня
область: область
они: они ими них
клещ: клещей клещи клеща
знакомый: знакомые
дополнительный: дополнительной
внутриутробный: внутриутробный внутриутробно
владелец: владельцы
диагноз: диагноз
природа: природу
необходимый: необходима необходимые
входить: входящие
кормить: кормящих
употребление: употреблении употребление
быстро: быстро
время: временем время
весной: весной
распределяться: распределяется
внутренний: внутренних внутренние
выходить: выходят
сильный: сильный
ранее: ранее
проблема: проблемы проблем
плановый: плановой
вялость: вялость
также: также
обитать: обитающие
появиться: появится
получение: получения
поддержание: поддержанию
комплексный: комплексная комплексной
мебель: мебель мебели
допускать: допускайте
написать: напишем
сначала: сначала
постирать: постирать
напольный: напольному
симптом: симптомы
подрывать: подрывают
распыление: распыления
гребень: гребнем
дискомфорт: дискомфорт
однако: однако
последствие: последствиям
паразитический: паразитическую
часы: часов
рекомендоваться: рекомендуется
понижаться: понижается
рекомендовать: рекомендованного рекомендуем
отзыв: отзыв
лайм: лайма
заражаться: заражаются
один: один одного
повреждение: повреждений
оценка: оценки
обязательно: обязательно
гельминтоз: гельминтоз гельминтоза
откладывать: откладывает
пример: примеру
мера: меры
глистный: глистной
пользоваться: пользуйтесь
оценить: оцените
эктопаразит: эктопаразиты эктопаразитов
сумка: сумках
возникать: возникает
минута: минут
вовсе: вовсе
инструкция: инструкцию
некоторый: некоторое
лето: летом
часто: часто
некоторые: некоторых некоторые
укус: укусы
обувь: обуви
плюсовой: плюсовых
лопатка: лопаток
способный: способны способные
кожа: коже
среда: среду среда
говорить: говоря
делать: делать
одновременно: одновременно
обработать: обработать
среди: среди
повторить: повторить
кишечник: кишечник кишечнике
качество: качестве
через: через
ковер: ковры
воспользоваться: воспользуйтесь
вследствие: вследствие
взрослый: взрослой
становиться: становится
врач: врач врачом врачу
меняться: меняется
доставлять: доставляют
назначить: назначит
поставить: поставить
должен: должна
окружать: окружающую
опасность: опасность
являться: являются
бывать: бывают
конечно: конечно
заразить: зараженный заражена
животное: животные животного животных
плацентарный: плацентарный
наоборот: наоборот
труднодоступный: труднодоступные
временить: времени
флакон: флакон
достаточно: достаточно
обладать: обладают
нужно: нужно
инфекционный: инфекционное
возможно: возможно
почва: почвой
понос: понос
группа: группы
провести: проведена провести
обработка: обработка обработки обработку обработке
это: это этом этого
распылить: распылите
два: две
обнаружить: обнаружить обнаружив
ошейник: ошейников
покрытие: покрытию
стоить: стоит
его: его
инвазия: инвазии
иметься: имеющихся
эндопаразит: эндопаразиты
эффект: эффектом
только: только
удивляться: удивляются
уничтожить: уничтожит
язвочка: язвочки
капля: капель
нельзя: нельзя
улица: улице
заражение: заражению заражения
или: или
далеко: далеко
возраст: возраста
инсектицидный: инсектицидными инсектицидный
допустить: допустить
особь: особи особью
защита: защита защиты
теплый: тепло теплая теплое теплых
почему: почему
случаться: случается
наносить: наносят
наноситься: наносятся
подхватить: подхватить
когда: когда
играть: играет
значит: значит
затем: затем
присыпка: присыпок
действие: действия
чего: чего
болезнь: болезнь
разрешить: разрешённые
вещество: вещество веществу
заразиться: заразиться
осень: осенью
всасываться: всасывается
вопрос: вопросы
появляться: появляются
подвал: подвалах
деятельность: деятельность
наблюдаться: наблюдаются
поскольку: поскольку
вычесывание: вычесывании
ваш: вашей ваш
так: так
ответ: ответы
резиновый: резиновыми
четвероногий: четвероногий четвероногих четвероногого
рекомендация: рекомендации
печальный: печальным
ведь: ведь
где: где
протереть: протрите
срок: срока
выделение: выделениями
активный: активны активную
благоприятный: благоприятные
попадание: попадания
использование: использовании использованием
неделя: неделю недель
самый: самым
подождать: подождать
товар: товар
выезд: выездом
быть: была было быть
печень: печень
снижаться: снижается
перемена: перемены
терять: теряет
частота: частота
яйцо: яйца яйцо
дозировка: дозировку
есть: есть
ряд: ряда
мочь: могут может можете
попадать: попадает попадают
этот: эти этой
сам: само
сказать: сказано
сердце: сердце
пироплазмоз: пироплазмоз
друг: друг
убивать: убивают
вирусный: вирусное
основной: основных
иммунитет: иммунитет
гельминт: гельминтов гельминты гельминта гельминтами
моча: мочой
кошка: кошек
можно: можно
применение: применения применению
дать: данная дать
болезненный: болезненны болезненные
действовать: действующее действующему
снег: снег
минимальный: минимальных
утилизировать: утилизируйте
аппетит: аппетит аппетита
вес: вес
своевременный: своевременно
влажность: влажность
уже: уже
извинить: извините
вакцинация: вакцинации
барьер: барьер
раз: раза
того: того
вы: вы
оставить: оставьте
необходимо: необходимо
соблюдать: соблюдать
рвота: рвота
вялый: вялым
регулярный: регулярной
оболочка: оболочки
личной: личных личные
простой: проще просты
превращение: превращения
поражать: поражать
щенок: щенки щенкам щенка
свой: свою
пройтись: пройдитесь
тем: тем
чтобы: чтобы
без: без
матрас: матрасы
перед: перед
предупреждать: предупреждая
шерстить: шерсти
аэрозоль: аэрозоль аэрозоли аэрозолем
между: между
до: до
рождение: рождения
высыхание: высыхания
нуждаться: нуждаются
особенность: особенность
потом: потом
мытье: мытья
ежедневный: ежедневном
адрес: адрес
другой: другие других другими другой
представить: представлены
отпугивать: отпугивающим отпугивают
давать: дают давать
вовремя: вовремя
ее: ее
регулярно: регулярно
сочетание: сочетания
посол: после
лежак: лежак лежака
применить: применить
ворс: ворсу
причина: причине
термический: термическая
еженедельно: еженедельно
вид: виде виды
же: же
превратиться: превратилось
выяснить: выяснили
подошва: подошве
польза: пользе
вымыть: вымойте
всегда: всегда
энцефалит: энцефалит
мыло: мылом
путь: пути
что: чем что
подверженный: подвержены
зуд: зуд
за: за
тип: типа
предмет: предметы
домашние: домашние домашних
паразит: паразитов паразиты паразитами
котенок: котятам котенка котята
домашний: домашнего
форма: форма
дом: дом
ожидать: ожидают
поверхность: поверхность поверхности поверхностей
завершать: завершают
зависеть: зависит
реж: реже
процедура: процедуру
если: если
размножаться: размножаются
любой: любое
организм: организме организм
из: из
подъезд: подъездах
наш: наши
ветеринарный: ветеринарный ветеринарным ветеринарному
серьезный: серьезная серьезные
ранний: ранней
удобный: удобная
внутри: внутри
их: их
насекомое: насекомые насекомых насекомое
контакт: контакте контакт
компонент: компоненты
вязка: вязкой вязки
заказ: заказ
зимой: зимой
грязный: грязной
сделать: сделаем
надолго: надолго
здоровье: здоровья здоровьем здоровье
тело: теле
нанести: нанести нанесите
пропылесосить: пропылесосьте
точный: точный
неутешительный: неутешительный
влажный: влажная влажных влажной
повышаться: повышается
испытывать: испытывает
новорожденный: новорожденного
пылесос: пылесосом
год: года
пакет: пакетах
защитить: защитить
симптоматика: симптоматика
обратиться: обратитесь
собака: собак
характерный: характерна
парогенератор: парогенератором
лечение: лечению
мать: матери
малыш: малышей
безопасность: безопасности
беременная: беременной беременных
который: которыми которого которых которые который
вывод: вывод выводы
поэтому: поэтому
комбинировать: комбинировать
стремительно: стремительно
например: например
любимец: любимца любимец любимцу любимцам
ли: ли
привести: привести
пища: пищи
вещь: вещей вещи
уничтожать: уничтожая
супермаркет: супермаркета
выбрать: выбрать выбранного
вот: вот
повышенный: повышенный
хорошо: хорошо
итак: итак
температура: температурах
такой: такие такое такого такой
понять: понять
ощущение: ощущения
вместе: вместе
жить: жить
мусор: мусором
несколько: несколько
питомец: питомца питомец питомце питомцев
домовый: домов
место: местах места
начало: начала
предпочитать: предпочитают
оптимальный: оптимальные
рука: руки
проходить: проходят
натуральный: натуральной натуральными
плинтус: плинтусы
лежать: лежит
мы: мы
слизистая: слизистые
на: на
состав: состав
носитель: носителя носителями
тот: тех том
не: не
ранка: ранки
использовать: использованный
каждый: каждому
наиболее: наиболее
указать: укажите
но: но
поздний: поздней
почта: почту
выпускаться: выпускаются
проветрить: проветрить
тряпка: тряпкой
внешний: внешних внешние
идеальный: идеальные
три: трех
появление: появления
длить: для
обрабатывать: обрабатывать обрабатывайте обрабатывая
начинать: начинают начиная
количество: количество
личинка: личинку личинка личинок личинки
орган: органы
развитие: развития
даже: даже
от: от
блоха: блох блохи блохами
как: как
кал: калом
все: все
препарат: препараты препарата препарат
глист: глисты глистами глистов
условие: условия
обивка: обивке
помогать: помогает
возможность: возможности
ковров: ковров
по: по
стадий: стадий
достижение: достижения
легкое: легкие
самка: самка самки самку самок
опасный: опасны опасных
принять: принятые принять
риск: риск
одежда: одежду
подбираться: подбирается
проникать: проникать проникая
способ: способ
высокий: выше
какой: какое какого
забывать: забывайте
наличие: наличии
признак: признаки
переть: при
