подача: подача
аквариумный: аквариумных аквариумное
поворачиваться: поворачивается
состоять: состоит
будить: будят
дозировка: дозировкой
есть: есть
найти: найдете
представлять: представляют
еще: еще
установить: установленный
происходить: происходит
рот: ртом
вдруг: вдруг
обзор: обзор
мочь: можете
отвести: отведенное
попадать: попадает
лапа: лапы
воды: воды
сам: сами
делиться: делятся
пить: пьет
объем: объема
четыре: четыре
доступ: доступ
опустошение: опустошения
друг: друга
помощь: помощью
а: а
кормушка: кормушка кормушку
изготовить: изготовлен
сохранить: сохранит
в: в
основной: основных
заболевание: заболевания
инновационный: инновационные
кошка: кошек
и: и
к: к
о: о
подходить: подходящее
насколько: насколько
настраивать: настраивать
с: с
средство: средств
у: у
определить: определенное
смочь: сможете
уезжать: уезжаете
они: они них
дополнительный: дополнительных
производитель: производитель
откидной: откидной
вариант: вариант
обеспечить: обеспечит
раз: раз раза
вы: вы вам
магазин: магазина
оставить: оставьте
теперь: теперь
необходимый: необходимом необходимы
бояться: боясь
опытный: опытных
кормить: кормить
перекачивать: перекачивает
время: время
забыть: забыли
кормление: кормлений
электроэнергия: электроэнергии
свое: своего свои
автоматический: автоматическая
режим: режим
пополняться: пополняется
тем: тем
заботиться: заботиться
язычок: язычок
популярный: популярные популярна
чтобы: чтобы
также: также
отключение: отключения
корма: корм корма
чистый: чистой
насыпаться: насыпается
интервал: интервал
рацион: рацион
сегментный: сегментная сегментные
появиться: появится
свежесть: свежесть
устройство: устройства устройством
получение: получения
запрограммировать: запрограммированное
удобно: удобно
засыпаться: засыпается
особенность: особенности
адрес: адрес
представить: представлено
клетка: клетки
работа: работы
требовать: требуя
комфортно: комфортно
популярность: популярностью
утро: утром
лоток: лоток
подбирать: подбирая
надавливать: надавливает
себя: собой
рекомендоваться: рекомендуются
задерживаться: задерживаетесь
рекомендовать: рекомендуем
отзыв: отзывы отзыв
вид: виды
отрываться: отрывается
грызун: грызунов
купить: купить
подавать: подает
пластиковый: пластиковая
один: один
оценка: оценки
всегда: всегда
иметь: имеющих имеет иметь
совет: советы
что: что чем
мера: мере
пользоваться: пользуются
тип: тип типа
за: за
оценить: оцените
домашние: домашних домашние домашним
домашний: домашнее домашнего
насос: насос
рейтинг: рейтинг
ожидать: ожидают
разделить: разделена
крепиться: крепиться крепятся
залог: залог
помочь: помочь
зависеть: зависит
бренд: бренда
существовать: существуют
если: если
досматривать: досматривать
надежность: надежность
подвести: подведем
из: из
ограничение: ограничения
наш: наши наших
технология: технологий
ранний: ранним
наливаться: наливается
остаться: останется
среди: среди
съедание: съедания
преимущество: преимущества
через: через
заказ: заказ
шарик: шарик
подойти: подойдет
израсходование: израсходования
мочекаменный: мочекаменной
особенно: особенно
рынок: рынке
здоровье: здоровья
большой: наибольшей большое
закрытый: закрыта
обращать: обращайте
разный: разных
механический: механическая механические
бывать: бывают
животное: животных животное животным
кто-то: кого-то
таймер: таймер
жидкость: жидкости
новинка: новинки
собака: собак
открывать: открывая
гарантированный: гарантированно
нужно: нужно
безопасность: безопасность
который: которые который котором которое которую которой которым которых
постоянный: постоянный
отличный: отличный
нетрудно: нетрудно
актуально: актуально
хронический: хронические
автокормушка: автокормушки автокормушку автокормушка автокормушек
любимец: любимец
следующий: следующие
это: это
сперва: сперва
подобрать: подобрать
ли: ли
наполняться: наполняется наполняются
два: два двумя
удобство: удобство удобством
просить: просить
случай: случае
кот: кот
покупатель: покупателей
такой: такие
его: его
только: только
жизнь: жизни
вод: вода воде воду
нужный: нужных нужное нужны
несколько: нескольким несколько
питомец: питомцев питомца питомец питомцу питомцами
поилка: поилка
мохнатый: мохнатого
или: или
проходить: проходит
питьевой: питьевом питьевой питьевые
возраст: возраст
благодаря: благодаря
мы: мы
летний: летний
поить: поить
на: на
резервуар: резервуарами резервуара резервуар
свежий: свежей
не: не
использовать: использовать использующих
уход: уход уходе
выбор: выборе выбору
гарантийный: гарантийный
указать: укажите
миска: миска миску
хороший: хорошего лучше лучших
много: много более
но: но
аквариум: аквариума
почта: почту
отсек: отсек
советовать: советуем
когда: когда
течь: течет
емкость: емкость
длить: для
автопоилка: автопоилки автопоилок автопоилка
категория: категориях
количество: количество
содержаться: содержится
контейнер: контейнер
составить: составили
либо: либо
принести: принесет
болезнь: болезнью
чего: чего
список: список
развитие: развитию
состояние: состояние
даже: даже
показание: показаниям
от: от
пять: пять
итог: итоги
программировать: программируемые
стимулировать: стимулируют
сон: сны
как: как
внимание: внимание
размер: размер
все: все
сохранять: сохраняет
руководствоваться: руководствуйтесь
просыпаться: просыпаются
помогать: помогают
ваш: вашему вашего ваших ваше вашей ваш
крышка: крышкой крышка крышке
так: так
мнение: мнению
по: по
четвероногий: четвероногого
пернатое: пернатого
расписание: расписанию
больший: больше большего
срок: срок
склонный: склонных
ожирение: ожирению
фонтанчик: фонтанчике фонтанчиков
оборудование: оборудование
способ: способ
товар: товаров товары товар
какой: каких какие какая какими
бесперебойный: бесперебойного
наличие: наличии
выбирать: выбирайте
быть: будет
дозатор: дозатором
источник: источник
прут: прутьям
переть: при
