поездка: поездок поездкам поездках поездкой
стандартный: стандартной
специальный: специальные специальная специальных
нервничать: нервничать
новый: новые
поведение: поведение
найти: найдете найти
любить: любимые
маршрутный: маршрутном
обзор: обзор
позаботиться: позаботиться
лапа: лапы
воды: воды
вероятно: вероятно
путешествие: путешествие путешествий путешествию путешествиях путешествия
касаться: касается
важный: важно важное
полный: полной
предел: пределы
килограмм: килограммов
насладиться: насладиться
а: а
в: в
соответствовать: соответствовать
содержание: содержание
пункт: пункта
и: и
к: к
о: о
поезд: поездах поездов поездом
с: с
транспортировочный: транспортировочную транспортировочном транспортировочный
средство: средства средством
у: у
шпиц: шпиц
запах: запахи
шар: шара
сезон: сезон
они: они
авто: авто
населенный: населенного
собрать: соберите
природа: природе
пройти: пройти
земной: земного
подготовиться: подготовиться
водитель: водителю водители
необходимый: необходимого
этап: этапе
опытный: опытные
расположить: расположить расположен
абсолютно: абсолютно
автомобильный: автомобильную
небольшой: небольшие
миниатюрный: миниатюрному миниатюрного миниатюрных
подробно: подробно
также: также
появиться: появится
город: город города
получение: получения
комфорт: комфорте
подробность: подробности
следовать: следовать
удобно: удобно
восемь: восьми
написать: напишем
пикник: пикников
прийтись: придется
снова: снова
электричка: электричках
везти: везете
территория: территории
находиться: находитесь
начать: начните
сидеть: сидит
комфортно: комфортно
каркас: каркас
размещать: размещать
однако: однако
себя: собой себя
предназначить: предназначенных
часы: часов
намордник: намордник
размещение: размещения
сумма: сумма
рекомендовать: рекомендуем
дамский: дамских
отзыв: отзыв
городской: городском
постепенно: постепенно
допускаться: допускаются
оценка: оценки
обязательно: обязательно
иметь: имеет
посетить: посетить посетите
длина: длине
мера: мере
жесткий: жесткий жесткого
оценить: оцените
зной: зной
часть: часть
практический: практически
самолет: самолетами самолета
сумка: сумок
лето: лето
обсудить: обсудим
помочь: поможет
скопление: скопление
делать: делать
сиденье: сиденье
комфортный: комфортное комфортным
авиаперевозчик: авиаперевозчиков авиаперевозчика
через: через
врач: врач
превышать: превышает превышать
администрация: администрацией
нравиться: нравятся
купе: купе
пешком: пешком
большой: большое
должен: должны должна должен
являться: является
животное: животных
исключить: исключить
мешать: мешать
подготовка: подготовку подготовка
нужно: нужно
достаточно: достаточно
закрепить: закреплен
возможно: возможно
совместный: совместному
травмировать: травмировал
это: этим это
большинство: большинства
закон: законы
вкус: вкус
пекинес: пекинесы
плацкарта: плацкарте
изучить: изучите
вполне: вполне
взять: взять
стоить: стоит
остановка: остановки
измерение: измерений
заблаговременно: заблаговременно
только: только
остальное: остальных
подвигаться: подвигаться
сантиметр: сантиметров
ветеринар: ветеринара
дорога: дорогу дороге
держать: держать
норка: норку
или: или
размещаться: размещаются
звук: звуки
разместиться: разместиться
возраст: возраста
габарит: габариты
теплый: тепло
подсказать: подскажет
темпераментный: темпераментного
воспринимать: воспринимают
быстрый: быстрее
спокойный: спокойного
хороший: хорошая лучше
пугать: пугать
много: много
отсек: отсек
постелить: постелите
когда: когда
значит: значит
прокатиться: прокатиться
учитывать: учитывать
билет: билет
укрытие: укрытие
контейнер: контейнером контейнера контейнер
размяться: размяться
разрешить: разрешат
список: список
масса: масса
настроение: настроение
норма: нормы
обязательный: обязательны
стук: стук
приобрести: приобрести
ширина: ширине
значение: значение
вопрос: вопросом
открыть: открыты
выполнить: выполнены
никто: никто
компания: компании
уютный: уютных
волновать: волновать
размер: размеры размер
корзинка: корзинок
высота: высоте
ваш: вашего вашей вашему ваш ваше
главное: главное
так: так
там: там
французский: французские
приравнять: приравнены
федерация: федерации
четвероногий: четвероногого четвероногие четвероногому
ведь: ведь
где: где
вентиляция: вентиляция
кто: кто кому
активный: активного
считаться: считаются
потребоваться: потребоваться потребуются потребуется
зафиксировать: зафиксирован
самый: самым
товар: товар
быть: будет быть
общественный: общественном общественный
устать: устанут
точка: точке
автомобиль: автомобиле автомобиля
тоже: тоже
успокоительный: успокоительные успокоительных
достаточный: достаточного достаточное
есть: есть
внимательно: внимательно
ряд: ряд
транспорт: транспорте транспорт
путешественник: путешественники
задуматься: задуматься
приобретение: приобретения
аптека: аптеке
мочь: могут
этот: этой
сам: самого самое
четыре: четыре
колесо: колес
перевозка: перевозки перевозка перевозке
отлично: отлично
разнообразный: разнообразных
тойтерьер: тойтерьер
правило: правилам правилами
народ: народа
чемодан: чемодан чемоданы
стресс: стресс
можно: можно
дать: данным
персональный: персонального
сложиться: сложится
организовать: организовать
подстилка: подстилку
смочь: сможете смогут
готовый: готовы
уже: уже
впервые: впервые
извинить: извините
цвет: цвет
того: того
вы: вы вам вас
оставить: оставьте
российский: российской
паспорт: паспорта паспорт
специалист: специалисты
соблюдать: соблюдать
брахицефальный: брахицефальных
щенок: щенка
обычно: обычно
свое: свои
груз: грузу
требование: требованиям
чтобы: чтобы
без: без
плед: плед
перед: перед
необходимость: необходимости
правильно: правильно
перевозить: перевозить
особенность: особенности
представитель: представители
положить: положите
мелкий: мелких
адрес: адрес
другой: другие
клетка: клеток
зоомагазин: зоомагазине зоомагазинах
регламентироваться: регламентируется регламентируются
проконсультироваться: проконсультируйтесь
запретить: запретит
период: период
бульдог: бульдоги
вылезать: вылезать
маршрут: маршрутов маршрута маршруты
вдумчиво: вдумчиво
вид: виде
же: же
выяснить: выясните
следование: следования
всегда: всегда
надежно: надежно
везде: везде
оба: оба
путь: пути
что: что
длительный: длительной длительных
править: правила правил правило
за: за
домашние: домашних
удовольствие: удовольствием
продумать: продумайте
ожидать: ожидают
брать: брать
пристегнуть: пристегнут
попить: попить
пространство: пространство
гамак: гамак
ржд: ржд
статья: статье
если: если
существовать: существует
хозяин: хозяином
любой: любой любом любого любые
захотеть: захотите
пушистый: пушистого
из: из
ограничение: ограничений
изделие: изделий
наш: нашей
ветеринарный: ветеринарного ветеринарный ветеринарной ветеринарную
ранний: раннего
удобный: удобнее
внутри: внутри
аптечка: аптечку
над: над
такси: такси
заказ: заказе заказ
борт: борт
игрушка: игрушки
мопс: мопсы мопс
предъявить: предъявить
авиакомпания: авиакомпании
терьер: терьер
салон: салоне
тщательно: тщательно
дорожный: дорожного
класть: клади
такса: такса
обращать: обращайте
предупредить: предупредите
компаньон: компаньона компаньону
движение: движения
ручной: ручной
машина: машины
собака: собаками собаке собаки собаку собак
собирать: собирайте собираем
поводок: поводок
резкий: резкие резком
малыш: малыши малыша
управление: управлению
безопасность: безопасности
который: которых которые которым котором который
вывод: выводы
поэтому: поэтому
например: например
любимец: любимца любимцу
багажный: багажный
пляж: пляж
вещь: вещей
выбрать: выбранной выберите
вот: вот
страна: страны
просить: просят
случай: случае
прививка: прививки прививках
путешествовать: путешествуют путешествовать путешествуете путешествует
дальний: дальнего
такой: таких такого
вместе: вместе
нужный: нужных
создание: создании
несколько: несколько
питомец: питомцем питомца питомцы питомцев питомец питомцу
пудель: пудель
заставить: заставить
место: месте места местах местом
безопасно: безопасно
транспортный: транспортным
ремень: ремнем
рука: руках
отдых: отдыхом
мы: мы
летний: летний
крайне: крайне
загораживать: загораживать
на: на
тот: тех то те
не: не
выбор: выбора
каждый: каждой каждые
задний: заднее
указать: укажите
но: но
маленький: маленькими мало
почта: почту
авиаперевозка: авиаперевозок
советовать: советуют советуем
привычный: привычный
три: трех
длить: для
гудок: гудок
любопытный: любопытного
составить: составили составьте
согласно: согласно
уточнять: уточняйте
справка: справки
духота: духота
редко: редко
он: он нему
даже: даже
статистика: статистики
бокс: боксе
пассажир: пассажир пассажиров
как: как
помять: помните
внимание: внимание
все: все всем всего
препарат: препараты
условие: условии
беспокойство: беспокойство
по: по
непромокаемый: непромокаемая
приучать: приучать приучайте
безопасный: безопасное безопасным безопаснее
подготовить: подготовите
отпуск: отпусков отпуске
торможение: торможении
порода: пород
способ: способ
какой: какие
наличие: наличие наличии
переносок: переноске переноску переноски переносках
заранее: заранее
переть: при
