выплескивать: выплескивать
специальный: специальной специальный
банк: банки
нагрузка: нагрузки
есть: есть
темнеть: темнеет
прогулка: прогулку прогулки прогулка прогулок прогулках прогулке
еще: еще
простудиться: простудиться
любить: любят
физический: физические физической
помешать: помешать
мочь: могут может
успех: успехи
со: со
менее: менее
погода: погоду
под: под
проверять: проверяйте
плохо: плохо
а: а
вообще: вообще
в: в
основной: основные
смыть: смойте
выводить: выводить
и: и
к: к
можно: можно
о: о
продолжаться: продолжаться
корка: корка
с: с
ограничиться: ограничиться
возможный: возможны
снег: снегу снег
они: им они
во: во
наступать: наступает
ветер: ветры
отпускать: отпускаете
успеть: успел
вы: вы вам
оставить: оставьте
необходимый: необходимы
разбить: разбитые
бояться: боитесь
необходимо: необходимо
быстро: быстро
время: время
россия: россии
забыть: забудьте
про: про
смотреть: смотрите
бутылка: бутылки
рано: рано
выходить: выходить
свой: свою
очистить: очистить
сильный: сильные сильно сильный
свое: своими своих своего
обморожение: обморожения
чтобы: чтобы
да: да
появиться: появится
энергия: энергию
получение: получения
понравиться: понравятся
легко: легко
комбинезон: комбинезон
полярный: полярный
образовываться: образовываться
декоративный: декоративные
надевать: надевайте
снова: снова
особенность: особенности
северный: северных
потом: потом
мелкий: мелких
мазь: мазью
адрес: адрес
справить: справить
вынудить: вынуждены
мороз: морозы
заняться: заняться
ее: ее
песик: песик
перемещение: перемещениями
посол: после
выгуливать: выгуливать
сколько: сколько
короткий: короткими
темнота: темноты
отзыв: отзыв
разбросать: разбросано
купить: купите
оценка: оценки
одевать: одевайте
консервный: консервные
везде: везде
метель: метель
что: что
стильный: стильные
за: за
пользоваться: пользуйтесь
оценить: оцените
урон: урон
поощрять: поощряйте
ожидать: ожидают
дорогой: дороги
некоторые: некоторых некоторые
получаться: получается
статья: статье
если: если
захотеть: захочет
потерять: потерять потеряете
минимизировать: минимизировать
способный: способны
подстерегать: подстерегают
делать: делать
наш: нашей
естественный: естественной
обработать: обработайте
их: их
кольцо: кольца
заказ: заказ
воспользоваться: воспользоваться воспользуйтесь
зимой: зимой
игрушка: игрушки
оказаться: оказаться
приучить: приучить
длинношерстный: длинношерстных
следить: следите
перепад: перепадах
тщательно: тщательно
нанести: нанести
должен: должна
довольный: довольно
опасность: опасности
посыпать: посыпают
из-за: из-за
пес: пес
поздно: поздно
наоборот: наоборот
собака: собаку собак собаки собакам
достаточно: достаточно
нужно: нужно
который: которым которые
поэтому: поэтому
легкий: легче
уследить: уследить
переносить: переносит
это: этом это этого
ошейник: ошейник
рассказать: расскажем
вполне: вполне
светящийся: светящийся светящимися
инструмент: инструменты
температура: температур
такой: такими такую таким
его: его
мусор: мусор
покупать: покупайте
питомец: питомец питомцев питомца
улица: улицах
шапка: шапка
регион: регионах
или: или
далеко: далеко
приспособить: приспособлены
мы: мы
стеклянный: стеклянные
перечислить: перечислим
действительно: действительно
на: на
теплый: теплый теплее
тот: то
не: не
использовать: используйте
образоваться: образуется
сложно: сложно
указать: укажите
хороший: лучше
почта: почту
разрешать: разрешайте
когда: когда
промывать: промывайте
длить: для
дождь: дождь
поваляться: поваляться
он: он него
даже: даже
от: от
парка: парках
бегать: бегайте
игра: игры
попробовать: попробовать
как: как
лапка: лапки лапкам
все: все
низкий: низким
ваш: вашей ваш
так: так
ведь: ведь
больший: больше большие
мыть: мойте
кто: кто
песок: песком
риск: риск
одежда: одежду
очень: очень
порода: пород породы
нацепить: нацепите
способ: способ
забывать: забывайте
товар: товар
какой: какие
наличие: наличие наличии
уходить: уходить
выбирать: выбирайте
охотно: охотно
быть: быть будет
переть: при
