специальный: специальные
тремор: тремор
новый: новые
день: дней дня
патология: патология
таблетка: таблетку таблеток таблетки
диагностик: диагностика
еще: еще
взбалтывать: взбалтывать
рот: рот
свести: сведен
гибнуть: гибнут
заключаться: заключается
обзор: обзор
попросить: попросите
эффективный: эффективно эффективна
делиться: делятся
со: со
содержимое: содержимое
под: под
предел: пределы
помощь: помощью
а: а
человек: люди
подмешать: подмешать
в: в
и: и
к: к
подходить: подходящее
с: с
она: она
средство: средств средство средства
у: у
относить: относят
непроходимость: непроходимость
применять: применять
лекарство: лекарство лекарства лекарствах лекарств
течение: течение
шампунь: шампунем
регенерация: регенерации
область: область области
они: они них
оно: оно
диагноз: диагноз
обращаться: обращайтесь
конкретный: конкретного
пройти: пройти
возникновение: возникновение возникновении
поместить: помещено
забирать: забирают
одышка: одышку
кормить: кормящим
слишком: слишком
пропускать: пропускайте
небольшой: небольшую
выходить: выходит
внутренний: внутренними внутренних
погладить: погладить
сердечная: сердечных
причинить: причинить
иной: иной
также: также
появиться: появится
получение: получения
понравиться: понравится
следовать: следует
погибнуть: погибших
комплексный: комплексный комплексным
легко: легко
предварительно: предварительно
молочный: молочного молочный
удобно: удобно
сначала: сначала
ослаблять: ослабляют
симптом: симптомы симптомами симптома
кровотечение: кровотечений
пассивный: пассивное
подбирать: подбирать
требоваться: требуется
редкий: редких редкие
хотя: хотя
закрыть: закрыть
рекомендоваться: рекомендуется
система: системы
читать: читайте
рекомендовать: рекомендуем
отзыв: отзыв
приятный: приятный
один: одна одного одно
оценка: оценки
иметь: имеет имеют
снизить: снизить
плоский: плоских
пример: примеры
подтверждать: подтверждает
оценить: оцените
часть: часть
дозироваться: дозируется
инструкция: инструкцию
некоторые: некоторые
бренд: бренда бренд
обувь: обуви
инфекция: инфекциями
тереть: три
процесс: процесс
способный: способны
кожа: кожа
курица: курицы
среди: среди
выдавить: выдавить выдавив
гурман: гурману
кишечник: кишечника
шея: шее
качество: качестве
через: через
взрослый: взрослых взрослым
подойти: подойдет подойдут
базироваться: базируется
становиться: становится
врач: врач врачом
большой: большой
встречаться: встречающихся
назначить: назначит
должен: должно
опасность: опасностей
являться: являются
заразить: зараженным
покидать: покидает
хотеть: хочет
весомый: весом
облегчать: облегчает
достаточно: достаточно
нужно: нужно
обладать: обладает обладают
инфекционный: инфекционных
немедленно: немедленно
обращение: обращения
вызывать: вызывают
группа: группе
травмировать: травмируют
это: этом это этого
обработка: обработки
большинство: большинства
вкус: вкусом вкус
еда: еду
обнаружить: обнаружены
молодая: молодых молодой
кой: коем
разница: разница
сироп: сиропы
суспензия: суспензия суспензии
начинаться: начинается
реабилитация: реабилитации
консультация: консультации
стоить: стоит
его: его
эффект: эффект
только: только
дегельминтизация: дегельминтизация
покупать: покупать
капля: капли каплях капель
пипетка: пипетка пипетки
заражение: заражение заражения заражении
отходы: отходы
или: или
трогать: трогать
возраст: возрасте возраста возраст
относиться: относится относятся
точно: точно
чаща: чаще
вырабатывать: вырабатывают вырабатывать
проконсультировать: проконсультировать
спот: спот
хороший: лучшее
слизать: слижет
много: более
наноситься: наносятся
когда: когда
подхватить: подхватит
профилактика: профилактики
учитывать: учитывайте
страдать: страдает
ленточный: ленточных
действие: действия действий
говядина: говядины
смешанный: смешанных
первый: первую
разрешить: разрешены разрешено
вещество: вещества
масса: массой
заразиться: заразиться
состояние: состояние
размер: размер
ваш: ваш вашей
тканый: тканей
против: против
так: так
главное: главное
иногда: иногда
возникнуть: возникнуть
больший: больше
мыть: мыть
поселиться: поселиться
самый: самый
товар: товар
быть: будете будет были быть
терять: терять
привкус: привкус
яйцо: яйца
мерный: мерного
есть: есть
внимательно: внимательно
представлять: представляем
провоцировать: провоцирует провоцируют
франция: франции
мочь: могут можете может
дыхательный: дыхательной
попадать: попадают
месяц: месяца
этот: этой эти
сам: сами самое
вскрыть: вскрыть
друг: друзья
убивать: убивают
совершение: совершения
классификация: классификация
иммунитет: иммунитет
гельминт: гельминты гельминтами гельминтов
кошка: кошке кошка кошек кошки кошкам
летальный: летальный
характер: характеру
стресс: стресс
бы: бы
можно: можно
применение: применению применения
дать: дадите дайте дали дать
действовать: действующие действующий действуют действует
возможный: возможны
использоваться: используются используется
некрупный: некрупным
во: во
вес: весе вес
своевременный: своевременная
уже: уже
вакцинация: вакцинацией
раз: раз раза
барьер: барьер
очередь: очередь
вы: вы
оставить: оставьте
проводить: проводить
цель: целях
необходимо: необходимо
обитание: обитания
побочный: побочными побочных побочные
сырой: сырой сырые
оболочка: оболочку
поражать: поражают
свой: свою
ветврач: ветврача
свое: своими свои
чтобы: чтобы
противопаразитарный: противопаразитарное противопаразитарным
привередливый: привередливым
кубик: кубики
перед: перед
до: до
глистогонный: глистогонные
сложный: сложнее
положить: положить
потом: потом
адрес: адрес
рыба: рыбу
давать: давать давайте дают
вовремя: вовремя
ее: ее
ослабить: ослабленным ослабленное
пожилой: пожилым
проконсультироваться: проконсультируйтесь
посол: после
профилактический: профилактический
период: период
порекомендовать: порекомендует
повредить: поврежденных
беременность: беременность
бледность: бледность
вид: вида видов виде
производиться: производятся
же: же
подошва: подошве
затруднить: затруднена
кровообращение: кровообращение
всегда: всегда
мыло: мылом
что: что чем
за: за
паразит: паразитами паразитов паразиты
спектр: спектром спектр
котенок: котятам котят
домашний: домашнего
форма: форме формы
ожидать: ожидают
разрушение: разрушение
желудочно-кишечный: желудочно-кишечных
применяться: применяются применяется
глотательный: глотательного
если: если
повод: поводу
любой: любые любая любой
пушистый: пушистому
организм: организме
из: из
сахарный: сахарных сахарные
занести: занести
ветеринарный: ветеринарный ветеринарным ветеринарную
легочный: легочные
удобный: удобны
их: их
мясо: мясо
токсин: токсинами
выявление: выявление
многие: многих
язык: языка
вязка: вязкой
заказ: заказ
грязный: грязной
съесть: съест
заметить: заметили
заниматься: занимайтесь
здоровье: здоровья
сходить: сходить
обращать: обращайте
прочий: прочие
адвокат: адвокат
разный: разными разного разных разные
стенка: стенок
будущее: будущему
кг: кг
распространить: распространенная распространенных распространенные
поселяться: поселяясь
истощить: истощенным
обратиться: обратитесь
упаковка: упаковке
гладить: гладить
лечение: лечение лечения
кишечный: кишечными кишечных
круглый: круглых
беременная: беременным беременной
который: которые
аромат: ароматом
вывод: выводы
поэтому: поэтому
выведение: выведения
холка: холку
легкий: легче
крупный: крупных
следующий: следующие следующих
вне: вне
ли: ли
подбора: подбора
вот: вот
улучшить: улучшить
случай: случае
сразу: сразу
такой: такие
спровоцировать: спровоцировать
полакомиться: полакомиться
плюс: плюс
паста: пасты паст
ухудшать: ухудшают
нужный: нужного
надежный: надежное
несколько: несколько
питомец: питомец питомца
место: место
никакой: никаких
непрошенный: непрошенные
корень: корень
широкий: широким широкий
включать: включая
противопоказание: противопоказаниям противопоказания
мы: мы
крайне: крайне
слизистая: слизистую
перечислить: перечислим перечисленных
на: на
тот: то тех тот
не: не
выбор: выборе
наиболее: наиболее
каждый: каждые
ни: ни
указать: укажите
кровь: кровь
усатый: усатого
но: но
маленький: маленький маленьким
почта: почту
вызвать: вызвать
выпускаться: выпускаются
внешний: внешних
длить: для
начинать: начинает
питательный: питательные
сливочный: сливочный
обратить: обратить
навредить: навредить
орган: органы
нет: нет
он: ему он него
даже: даже
от: от
желудок: желудка
установление: установлении
попробовать: попробуйте
как: как
внимание: внимание
все: все всех всем всего
принимать: принимать
препарат: препараты препаратов препарат препарата
низкий: ниже
глист: глистами глистов глисты
родитель: родителям
помогать: помогают
по: по
антигельминтный: антигельминтные антигельминтная
выпускать: выпускают
выпуск: выпуска
безопасный: безопасен
огромный: огромный
интоксикация: интоксикация интоксикации
комбинированный: комбинированных
опасный: опасные опасны
риск: риск
проникать: проникают
очень: очень
порода: пород породам
способ: способе способ
какой: какого
наличие: наличие наличии
достигать: достигая
источник: источниками
переть: при
