автомобиль: автомобиле
придумать: придумать придумайте
поездка: поездка поездки
тоже: тоже
выносливость: выносливость
вести: ведут
еще: еще
транспорт: транспорте
любить: любимую любят любимое
физический: физической
нетоксичный: нетоксичных
позаботиться: позаботиться
мочь: может могут
шуршать: шуршащие
любимица: любимица
сам: сама
путешествие: путешествия
важный: важно
касаться: касается
друг: другом
плохо: плохо
нести: несет несете
а: а
человек: людей
правило: правилами
издавать: издают
передвигать: передвигать
в: в
устраиваться: устраиваются
ловкость: ловкость
кошка: кошки кошек кошку кошка кошке
отправляться: отправляясь
и: и
охотничий: охотничий охотничьих
ознакомиться: ознакомитесь
к: к
известный: известных
времяпрепровождение: времяпрепровождение
можно: можно
о: о
подходить: подходят
с: с
она: нее
средство: средств
у: у
элемент: элементы
смочь: сможет сможете
запах: запах
дополнительный: дополнительной дополнительные
они: им они
производитель: производителей
латексный: латексные латексную
во: во
владелец: владелец
интерактивный: интерактивные
добыть: добыть
стремиться: стремясь
вы: вы вам
оставить: оставить оставьте
поместить: поместите
отвлечь: отвлечет отвлечь
необходимо: необходимо
сердечно-сосудистый: сердечно-сосудистой
диск: диск
планировать: планируете
время: время
быстро: быстро
чувствовать: чувствует
охлаждать: охлаждающие охлаждающую
порой: порой
веселый: веселых
щенок: щенка
просьба: просьбой
тревожный: тревожно
проблема: проблем
ненадолго: ненадолго
чтобы: чтобы
да: да
также: также
член: члены
появиться: появится
получение: получения
поддержание: поддержания
понравиться: понравится
между: между
удобно: удобно
легко: легко
полезный: полезна
взаимоотношение: взаимоотношений
гармоничный: гармоничных
пытаться: пытаться
положить: положить
альтернатива: альтернатива
адрес: адрес
другой: других
вечерний: вечернюю
трек: треки
заняться: заняться
пригодиться: пригодится
мячик: мячики
однако: однако
себя: себя собой
период: период
предназначить: предназначенные
пищать: пищащие
угощение: угощение
рекомендовать: рекомендуем
отзыв: отзыв
хищник: хищнику
же: же
успокаивать: успокаивающий
польза: пользе
пластиковый: пластиковый
один: одного
оценка: оценки
иметь: иметь имеют
заводной: заводные заводной заводным
грызть: грызть
что: что чем
мера: меры
зуб: зубов
заселиться: заселиться
жар: жару
громкий: громко
за: за
оценить: оцените
домашние: домашним домашних
паразит: паразитов
удовольствие: удовольствием
тренировать: тренировать
ожидать: ожидают
поверхность: поверхность
показатель: показатели
некоторый: некоторое
лакомство: лакомств
изготавливаться: изготавливаются
если: если
помимо: помимо
проявить: проявить
кусочек: кусочки
любой: любом
желательно: желательно
подвести: подведем
отличаться: отличаются
из: из
что-либо: что-либо
царапать: царапать
изделие: изделия изделие
мяч: мяч
наш: наши
ветеринарный: ветеринарному
внутри: внутри
кольцо: кольца
их: их
многие: многие
номер: номере
качество: качестве
заказ: заказ
игрушка: игрушку игрушки игрушка игрушками игрушек
порча: порчи
подойти: подойдет подойдут
материальный: материальную
врач: врачу
имущество: имущества
различный: различные
особенно: особенно
команда: команд
загородный: загородной
обращать: обращайте
должен: должно
разный: разных
впитать: впитала
животное: животным
обратиться: обратиться
собака: собак собаки собака собакам
берет: берете
устроить: устройте
нужно: нужно
безопасность: безопасности
который: которых которая которое которую
отличный: отличная
совместный: совместное
рельефный: рельефную
любимец: любимца любимцем любимцы
провести: провести
переносить: переносят переносит
это: это этого
молочная: молочных
поддерживать: поддерживать
родной: родного
подобрать: подобрать
массаж: массажу
пляж: пляже
вещь: вещей
ответственность: ответственность
привести: привести
учиться: учится
смена: смены
прочность: прочностью
выбрать: выбрать
помощник: помощник
настроить: настроены
случай: случае
взять: взять возьмите
стоить: стоит
путешествовать: путешествуют
такой: такое
его: его
только: только
текстильный: текстильные текстильную
несколько: несколько
питомец: питомцем питомцу питомец питомца
дорога: дорогу
или: или
собираться: собираясь
возраст: возраст возрасте
мы: мы
габарит: габаритах
участие: участие
чаща: чаще
на: на
причем: причем
свежий: свежем
имитировать: имитирующие
тот: то
не: не
выбор: выборе выбора
подумать: подумайте
каждый: каждый
указать: укажите
хороший: хорошей
чип: чипом
но: но
маленький: маленькому
тренировка: тренировке тренировка
почта: почту
гоняться: гоняться
когда: когда
вызвать: вызвать
профилактика: профилактика
играть: играют
внешний: внешним
длить: для
начинать: начинают
модель: моделям
выучить: выучить
понадобиться: понадобятся
нет: нет
дача: дачу даче
столбик: столбика
поиграть: поиграть
он: ему он него
состояние: состояние
обрести: обрел
даже: даже
наверняка: наверняка
звенеть: звенящие
от: от
итог: итоги
захватить: захватить захватите
приобрести: приобретите
выполнить: выполнены
тогда: тогда
способствовать: способствует
мягкий: мягкому мягкий
никто: никто
игра: игры игрой игр
установление: установлению
заполнить: заполните
как: как
внимание: внимание
все: все
принимать: принимать
перетягивание: перетягивание
помогать: помогают помогает
ваш: вашей ваш
так: так
по: по
четвероногий: четвероногому четвероногим четвероногих четвероногого
ведь: ведь
выпускать: выпускать
безопасный: безопасных
отель: отель
полость: полости
ожирение: ожирения
самый: самых
инстинкт: инстинкт
способ: способ
высокий: высокие
забывать: забывать
соревнование: соревнования
товар: товар
какой: какие
наличие: наличии
взаимодействовать: взаимодействовать
выбирать: выбирая
лабиринт: лабиринты
быть: будут быть будет было
общественный: общественном
переносок: переноски переноску
заранее: заранее
переть: при
что-то: что-то
