поездка: поездку
приводить: приводит
ухо: уши
найти: найти
служить: служит
удаваться: удается
происходить: происходит
любить: любящий любят
лапа: лапах
вокруг: вокруг
обменный: обменных
удар: ударе
важный: важно важную важная
доступ: доступе
под: под
прохладный: прохладном прохладных прохладное прохладной
охладиться: охладиться
легкость: легкостью
помощь: помощью помощь
нести: несет
смочить: смоченными
а: а
вода: водой
приспосабливаться: приспосабливаться
в: в
заболевание: заболевания
птичка: птички
и: и
живой: живого
к: к
о: о
плотно: плотно
вязкость: вязкости
с: с
она: она
у: у
подушечка: подушечки
они: они них им ними
дополнительный: дополнительные
оно: оно
природа: природе
вольер: вольера вольеры вольер вольерах
обращаться: обращайтесь
пот: пот
обеспечить: обеспечить
искать: ищите
расположить: расположена
абсолютно: абсолютно
небольшой: небольших небольшое
время: время
добиваться: добивается
кондиционер: кондиционеров
собраться: собрались
бутылка: бутылка
внутренний: внутренней
сердечная: сердечной
сильный: сильно сильный
составлять: составляет
максимально: максимально
также: также
чистый: чистой чистая
индивидуальный: индивидуальная
появиться: появится
получение: получения
растягиваться: растягивается
оставлять: оставляйте
следовать: следует
внимательный: внимательный
находиться: находится находиться
изменение: изменение изменения
симптом: симптомы
комфортно: комфортно
требовать: требуют
задача: задача
требоваться: требуется
редкий: редкая
повышать: повышает
однако: однако
закрыть: закрыть
часы: часы
укромный: укромное
система: системы система системой
далекий: подальше
тяжелый: тяжело
сквозняк: сквозняки сквозняков
рекомендовать: рекомендуем
отзыв: отзыв
прямая: прямых
подшерсток: подшерстком
нормальный: нормальная
один: одном
оценка: оценки
проветривать: проветриваемом
обязательно: обязательно
полностью: полностью
значительный: значительной
мочить: мочить
перенести: перенести перенесите
мера: мере
жар: жару жара
контролировать: контролирует
оценить: оцените
зной: зной
свобода: свободу
обернуть: обернутая
грибковый: грибковые
активность: активность
лето: лето летом
часто: часто
некоторые: некоторых
помочь: помочь поможет
усугублять: усугубляют
проявить: проявить
процесс: процессов процессу процесс процессах
избежать: избежать
подвести: подведем
обострять: обостряет
передвижение: передвижения
способность: способность
среда: среды
кожа: кожа
делать: делать
негативный: негативное
переохлаждение: переохлаждения
градус: градусов
комфортный: комфортная комфортного
пульверизатор: пульверизатора
через: через
гладкий: гладкий
возле: возле
перегрев: перегреву перегрева перегрев перегревом
становиться: становится
перепад: перепады
отдача: отдача
результат: результате
поднимать: поднимают
особенно: особенно
должен: должен должно должна должны
окружать: окружающей
опасность: опасность
выделяться: выделяется
являться: являются является
животное: животного
голодание: голодание
непривычный: непривычным
нужно: нужно
достаточно: достаточно
стать: стала
изменять: изменяет изменяя
кислородный: кислородное
вызывать: вызывает вызывающие
переносить: переносят
это: это
клюв: клюв
поддерживать: поддерживать
большинство: большинства большинство
ограничивать: ограничивать
смена: смена смене
разница: разницы
речной: речной
ограничить: ограничить
консультация: консультацией
теплопроводность: теплопроводность
только: только
менять: менять меняйте
научиться: научились
поилка: поилке поилки поилках поилка
держать: держать
поддерживаться: поддерживается
или: или
комнатный: комнатной
теплый: теплая тёплое тепла тепло
защита: защитой
теплоемкость: теплоемкость
воздействие: воздействие
охлаждение: охлаждения
уход: ухода
протирать: протирайте
особый: особого особый
хороший: лучше
регулировать: регулировать
осложнять: осложняет
относительно: относительно
окно: окна
прятаться: прячутся
когда: когда
играть: играет
разместить: разместить
губительный: губительны
разводить: разводить
первый: первая
приблизить: приближенные
итог: итоги
птица: птиц птицы птица
отметка: отметке отметки
мягкий: мягкому
луч: лучей
игра: игры
примерный: примерная
лапка: лапки
ваш: вашему вашего вашей ваш
именно: именно
плескаться: плескаться
переместить: переместите
пернатое: пернатых пернатым пернатые пернатого
ведь: ведь
больший: большем больше
протереть: протереть
хомяк: хомяки хомяков
постараться: постарайтесь
активный: активные
распространение: распространение
попадание: попадания
событие: событий
потовой: потовые потовых
самый: самым самая самый
чувствительный: чувствительны
товар: товар
быть: будет быть была
солевой: солевого
шерсть: шерсть
попугай: попугаи
аккуратный: аккуратно
расположение: расположения
опрыскивать: опрыскивать
теплов: тепловым
достаточный: достаточное
есть: есть
внимательно: внимательно
роль: роль
установить: установите
шубка: шубка шубки
провоцировать: провоцирует
мочь: может могут можете
этот: этой
активизироваться: активизируются
сам: самой
борьба: борьбы
погода: погоду
специфичный: специфично
отлично: отлично
нехитрый: нехитрым
воздух: воздуха
можно: можно
основное: основное
во: во
уметь: умеют
наступать: наступает
влажность: влажность
раз: раз
вы: вы
свободно: свободно
оставить: оставьте
варьироваться: варьируется
солнечный: солнечных
необходимо: необходимо
сердечно-сосудистый: сердечно-сосудистой
обитание: обитания
морской: морской
охлаждать: охлаждая охлаждает охлаждающие
порой: порой
свой: свою
обычно: обычно
густой: густому густой
чтобы: чтобы
пребывание: пребывания
дикий: дикой
без: без
до: до
сложный: сложный
помнить: помнить
декоративный: декоративному
особенность: особенности
мелкий: мелкие мелких мелким
ежедневный: ежедневные
адрес: адрес
другой: другие
теплолюбивый: теплолюбивой
клетка: клетках клетку клетке клетки клетка
работа: работу
обладатель: обладатели
утро: утром
защищать: защищать
период: период
простоять: простой
знать: знать
центральный: центральной
жаркий: жаркую жаркий
кроме: кроме
же: же
грызун: грызунов грызуны грызунам
плотный: плотным
всегда: всегда
купать: купать
что: что чем
подверженный: подвержены
править: правило
кровеносный: кровеносные
за: за
домашние: домашние
совсем: совсем
ожидать: ожидают
намного: намного
дегидратация: дегидратацию
спрятаться: спрятаться
свободный: свободном
залог: залог
обмен: обмена
зависеть: зависят
статья: статье
справляться: справляются
если: если
любой: любое
пушистый: пушистой
организм: организма организме организм
из: из
перемещаться: перемещаться
наш: наших наши нашим
ветеринарный: ветеринарному
пронизывать: пронизывают
днем: днём днем
ранний: раннее ранним
их: их
насекомое: насекомых
контакт: контакта
заказ: заказ
повышение: повышении
зачастую: зачастую
следить: следите
поступать: поступающего поступает
штора: шторы
приоткрывать: приоткрывают
оказывать: оказывают
различный: различные
теплоотдача: теплоотдачу
квартира: квартире
заметить: заметили
тело: тела
закрытый: закрытом
влажный: влажным
выделительный: выделительной
потоотделение: потоотделение
верный: верный
проявляться: проявляется
год: года
защитить: защитить
жидкость: жидкости
увеличение: увеличения
спасти: спасти
приходиться: приходится
забота: заботу заботы
резкий: резкая
стараться: стараясь стараются
малыш: малыша
управление: управления
постоянный: постоянная
который: которая которых которые которое
поэтому: поэтому
легкий: легче
участок: участки участками
крупный: крупные
любимец: любимцам любимцев любимцы любимца
следующий: следующими
располагать: располагайте
привести: привести
сказываться: сказывается
приток: приток
заморозить: замороженной
повышенный: повышенной повышенная
хорошо: хорошо
ночное: ночные
случай: случае
сразу: сразу
продолжительный: продолжительная
температура: температуры температура температуру температурой температуре
создать: создать
такой: такими такое таким
гипертермия: гипертермия гипертермии
деть: дело
спасаться: спасаются
вод: вода воду
тенистый: тенистое
нужный: нужен
неоперенный: неоперенные
надежный: надежной
несколько: несколько
питомец: питомцев питомцам питомцы питомцу питомца питомцем
место: место места местом
оптимальный: оптимальную оптимальная оптимальное
никакой: никакой
местечко: местечко
благодаря: благодаря
вредитель: вредителей
мы: нас мы
летний: летней летний летнюю
крайне: крайне
на: на
состав: состава
свежий: свежего свежая свежей
тот: те то
использовать: используют
не: не
указать: укажите
кровь: крови
частить: части
но: но
маленький: маленьким
поздний: поздним
почта: почту
советовать: советуем
вызвать: вызвать
проветрить: проветрить
внешний: внешней
идеальный: идеальной
длить: для
количество: количество количестве
ватный: ватными
содержаться: содержатся
уровень: уровне уровень
составить: составит
обратить: обратите
холодный: холодную
влияние: влияние
нет: нет
вентилятор: вентиляторов
развитие: развитие
он: он
даже: даже
от: от
регулироваться: регулируется
проветривание: проветривания
железо: железами
избегать: избегать избегайте
как: как
внимание: внимания
все: все всех
низкий: низких
условие: условии условиям условия
терморегуляция: терморегуляция терморегуляции
отсутствовать: отсутствуют отсутствует
по: по
безопасный: безопасного
беспокоить: беспокоят
тепловой: теплового тепловом
отпуск: отпусков
опасный: опасные
работоспособность: работоспособности
очень: очень
относительный: относительная
способ: способом способ
высокий: выше
кролик: кроликов кролики кролик кролика кролику
нервный: нервной
наличие: наличии
достигать: достигает
мех: меху
переть: при
