новый: новом
зимний: зимнюю
сквозь: сквозь
невероятный: невероятным
район: районе
понюхать: понюхать
любить: любимым
провоцировать: провоцирует
мочь: может
эффективный: эффективной
этот: эти этой
успех: успеха
со: со
сам: сами самой
важный: важно
признанный: признанных
помощь: помощью
отмереть: отмерший
а: а
в: в
восхищение: восхищение
кошка: кошек кошкам кошку кошки кошке
и: и
к: к
характер: характеру
можно: можно
о: о
дать: дайте данной
с: с
она: она
у: у
смочь: сможет
они: они ним них
адаптация: адаптации
собрать: соберут
своевременный: своевременное
снижение: снижения
пройти: прошел
раз: раз
того: того
вы: вы
оставить: оставьте
образование: образование образования
расческа: расческе
бояться: бояться
шерстный: шерстный
проводить: проводя
просто: просто
слишком: слишком
называть: называемых
регулярный: регулярное
сегодняшний: сегодняшний
кнопка: кнопку
россия: россии
забыть: забудете
свой: своей
регулярность: регулярность
препятствие: препятствием
проблема: проблема
свое: своим своего
тем: тем
популярный: популярных популярны
причинить: причинить
густой: густым
чтобы: чтобы
также: также
появиться: появится
получение: получения
хвалить: хвалите
перед: перед
следовать: следовать
шерстить: шерсти
легко: легко
до: до
спутывание: спутываний спутывания
адрес: адрес
уважение: уважение
начать: начните
выходец: выходцы
давать: даем давайте
ее: ее
направление: направлении
удалить: удалите
посол: после
питание: питание
сухой: сухой
период: период
вычесывать: вычесывая
знать: знать
комок: комков
рекомендовать: рекомендуем
отзыв: отзыв
же: же
подшерсток: подшерстка
постепенно: постепенно
приятный: приятный
один: одна одного
плотный: плотным
кровообращение: кровообращение
оценка: оценки
купать: купать
свойство: свойство
путь: путей
что: что
длина: длина
мера: меру
богатый: богата
за: за
тип: тип
оценить: оцените
котенок: котенок
нажать: нажмите
последний: последние
ожидать: ожидают
вовсе: вовсе
наслаждаться: наслаждаться
залог: залогом
некоторые: некоторых
процедура: процедуре процедуру
если: если
статья: статье
справляться: справляются
хозяин: хозяина
подвести: подведем
пушистый: пушистым
из: из
вознаграждать: вознаграждайте
кожа: коже
волосяной: волосяных
ранний: раннего
их: их
напоминать: напоминают
заказ: заказ
взрослый: взрослые
подойти: подойдет
приучить: приучить приучили
обладание: обладанию
около: около
особенно: особенно
тело: теле
должен: должны
выпасть: выпавшей
являться: является
здоровый: здоровой
проглотить: проглотить
дружелюбие: дружелюбием
кг: кг
животное: животного
гигантский: гигантского
наоборот: наоборот
предок: предки
удержать: удержать
стать: стали стал стать стала
достаточно: достаточно
интерес: интереса
прекрасно: прекрасно
который: который
поэтому: поэтому
легкий: легкий
соответственный: соответственный
это: этим это этом
холодное: холодного
королевский: королевским
два: двух
колтун: колтуны
наделить: наделены
случай: случае
инструмент: инструмент инструмента
стоить: стоит
такой: таким такое
его: его
улучшать: улучшает
деть: день
красивый: красивой
неприятный: неприятные
жить: жили жить
только: только
питомец: питомцы питомцем питомца питомцу
войти: вошла
место: местах
продолжить: продолжим
линька: линьки
или: или
мы: мы
пик: пиком
сбросить: сбросьте
на: на
приучение: приучение
теплый: тепло
тот: то
общение: общением
не: не
уход: ухода
использовать: используйте
наиболее: наиболее
суровый: сурового
указать: укажите
хороший: хорошее лучше
но: но
почта: почту
когда: когда
профилактика: профилактикой
длить: для
начинать: начинать
великан: великаны
распутывание: распутывания
обильный: обильной
список: список
он: ему
даже: даже
итог: итог
поистине: поистине
обязательный: обязательна
аналогичный: аналогично
длинный: длинной
тогда: тогда
мягкий: мягкая
как: как
размер: размер размерам размера
все: всем всего
вычесывание: вычесывания вычесывание
условие: условиях
против: против
ваш: вашему вашей ваш
так: так
возможность: возможности
по: по
ведь: ведь
осмотреть: осмотрите
больший: больших
внушать: внушает
склонный: склонны
зубчик: зубчиками зубчики
использование: использование использованием
расчесывать: расчесывать
неделя: неделю
очень: очень
проникать: проникая
порода: пород порода породы
способ: способ
какой: какой
товар: товар
наличие: наличие наличии
выбирать: выбирать
достигать: достигают достигать
переть: при
шерсть: шерстью шерсть
