витамин: витамины
специальный: специальными специально
питать: питает
день: дней
пометка: пометки
детство: детства
служить: служит
удаваться: удается
еще: еще
любить: любят
снимать: снимает снимают
постоялый: постоял
позаботиться: позаботьтесь
обзор: обзор
эффективный: эффективно
воды: воды
любимица: любимицу
со: со
коллоидный: коллоидная
важный: важно
противомикробный: противомикробный
легкость: легкостью
предложить: предложите
помощь: помощью
смочить: смочите
а: а
в: в
заболевание: заболеваний заболеваниях
немного: немного
отказаться: отказаться
и: и
к: к
жаловать: жалуют
о: о
подходить: подходят подходит
с: с
она: она ей
средство: средствами средства средство
у: у
шампунь: шампуня шампунь шампуни шампуней
они: им они них ним
бросить: бросьте бросить
салициловый: салициловая
пройти: пройдет
структура: структуру структуры
необходимый: необходимое необходим необходимы
себорея: себореи
поместить: поместите
бояться: боится
входить: входит входят
препятствовать: препятствуют
слишком: слишком
быстро: быстро
ушко: ушках
посоветоваться: посоветуйтесь
недавно: недавно
сильный: сильно
проблема: проблемы проблемой
купание: купания купание купанием
иной: иным
также: также
намылить: намыльте
появиться: появится
чай: чая
получение: получения
следовать: следует
предварительно: предварительно
прием: приема
легко: легко
вторичный: вторичной
свернуть: свернутыми
вред: вред
деготь: дегтем
бриллиантовый: бриллиантовый
какой-либо: какие-либо какое-либо какой-либо
мячик: мячик
удалить: удалите
короткошерстный: короткошерстным
предназначить: предназначены
рекомендоваться: рекомендуется
рекомендовать: рекомендуют рекомендуем
отзыв: отзыв
раковина: раковину раковины
успокаивать: успокаивает
приятный: приятным
пластиковый: пластиковый
оценка: оценки
экзотический: экзотических
иметь: имеют имеет имеющие
совет: советы
помыть: помыть
длина: длины
перенести: перенес
мера: мере
оценить: оцените
лишь: лишь
семейство: семейства
обернуть: оберните
инструкция: инструкцию
часто: часто
чабрец: чабрец
некоторые: некоторые
помочь: поможет
желательно: желательно
избежать: избежать
подвести: подведем
основа: основе
противогрибковый: противогрибковые противогрибковое
расчесать: расчешите
ковшик: ковшик ковшика
ромашка: ромашки
кожа: кожи кожу
делать: делать делающие
негативный: негативное
провитамин: провитамину провитамин
обработать: обработать
выдавить: выдавите
предотвращать: предотвращает
вытереть: вытрите
через: через
воспользоваться: воспользоваться воспользуйтесь
подойти: подойдут
приучить: приучить
врач: врачи врачом
превышать: превышать
должен: должна
заразить: заражены
животное: животных
временить: времени
подстричь: подстригите
флакон: флаконе флакон
грибков: грибковыми
повторный: повторного
обладать: обладает обладающий обладающее
придавать: придает
смягчать: смягчает
нежный: нежной
вызывать: вызывающие вызывает
восстанавливать: восстанавливает
операция: операцию
это: это этого
молочная: молочную
большинство: большинства
поддерживать: поддерживает
зеленый: зеленого
рост: рост
привлекать: привлекайте
взять: возьмите
стоить: стоит
кот: кота
его: его
справиться: справиться
улучшать: улучшающие улучшает
неприятный: неприятного
ломкость: ломкостью
эффект: эффекта эффектом
заткнуть: заткнуть
капля: капли
привлечь: привлечь
средний: средней
избавлять: избавляет
ладонь: ладонь
или: или
относиться: относятся
допустить: допустить
пригласить: пригласите
теплый: теплое
кокосовый: кокосовое кокосового
ванный: ванной
нескользящий: нескользящий
березовый: березовым
воспринимать: воспринимает
хороший: лучше
много: много
увлажнять: увлажняет
постелить: постелите
когда: когда
подхватить: подхватить
течь: течет
готовиться: готовится
профилактика: профилактики
учитывать: учитывать
промывать: промывает
намочить: намочить
действие: действие
испачкаться: испачкается
состояние: состояние
итог: итоги
мурлыка: мурлык мурлыкам
обязательный: обязательный
искусственный: искусственных
мягкий: мягко
стимулировать: стимулирует
лапка: лапки
лечебный: лечебных лечебные
ваш: ваша вашего вашей ваш
именно: именно
так: так
иногда: иногда
четвероногий: четвероногого
где: где
деликатно: деликатно
постараться: постарайтесь
активный: активные
попадание: попадания
привыкнуть: привыкла
предпочтение: предпочтения
самый: самым
товар: товар
быть: будет
шерсть: шерсть шерстью
налить: налейте
отказывать: отказывайте
есть: есть
нейтральный: нейтральный
разработать: разработанным разработаны разработанные
мочь: могут может
из-под: из-под
этот: этой этот
сам: самого
убивать: убивает
отлично: отлично
конский: конского
изготовить: изготовлен
бережно: бережно
основной: основные
иммунитет: иммунитет
смыть: смойте
кошка: кошки кошка кошку кошек кошкам
известный: известны
бы: бы
можно: можно
применение: применением применения
дать: данные
антисептический: антисептический
смочь: сможет смогла
кошачий: кошачьего
уже: уже
вы: вас
оставить: оставьте
восстановить: восстановить
образование: образование
проводить: проводить
необходимо: необходимо
луговой: луговых луговой
соблюдать: соблюдать
обойтись: обойтись
чувствовать: чувствовал
снижать: снижает
отнять: отнимет
свой: своей
статический: статического
вытащить: вытащите
устранять: устраняя устраняет
экстракт: экстракт
тем: тем
чтобы: чтобы
без: без
необходимость: необходимости
перед: перед
предупреждать: предупреждает
шерстить: шерсти
дома: дома
правильно: правильно
слегка: слегка
до: до
эластичность: эластичность
наблюдать: наблюдать
представитель: представители
положить: положите
мытье: мытью мытья
адрес: адрес
другой: другой другие
ее: ее
полотенце: полотенце
проконсультироваться: проконсультироваться
посол: после
придерживать: придерживать придерживайте
защищать: защищает
период: период
шум: шума
число: числе
экономный: экономно
ласковый: ласковым
вид: вид видов
же: же
бороться: борется
дно: дно
сбалансированный: сбалансированный
попасть: попала
поражение: поражениях
купать: купать
что: что
отдавать: отдавать
зуд: зуд
за: за
тип: тип типом типу
домашние: домашних
назначаться: назначается
паразит: паразитов
звуковой: звуковым
котенок: котенка котят
форма: форме
ожидать: ожидают
разделить: разделить
растительный: растительных
алоэ: алоэ
изготавливаться: изготавливается
зависеть: зависит
накопление: накопления
применяться: применяется
процедура: процедуру процедура
если: если
доходить: доходила
выпадение: выпадением
животик: животика
любой: любым
отношение: отношение
из: из
игровой: игровой
наш: наши
ветеринарный: ветеринарные ветеринарным
естественный: естественный
противовоспалительный: противовоспалительным противовоспалительное
ранний: раннего
их: их
коврик: коврик
укреплять: укрепляющие укрепляя укрепляет укрепляющим
очищать: очищает
компонент: компоненты
заказ: заказ
игрушка: игрушками
длинношерстный: длинношерстная длинношерстных
оказывать: оказывает
сделать: сделать
тщательно: тщательно
различный: различных
здоровье: здоровью
нанести: нанести
обращать: обращайте
нормализовать: нормализует
белый: белой белую
окрепнуть: окрепнет
будущее: будущих
собака: собакам собак
гладить: гладьте
лечение: лечения лечении
забота: забота
подвергать: подвергать
укрепление: укреплению
малыш: малыш малыша
беременная: беременную
ухаживать: ухаживать ухаживают ухаживает
который: которая который которые
аромат: ароматом
поэтому: поэтому
любимец: любимец любимцу любимцев любимца
подобрать: подобрать
универсальный: универсальных универсальные
уничтожать: уничтожает
выбрать: выбрать
вот: вот
хорошо: хорошо
инструмент: инструменты инструментов
прививка: прививкам прививку
температура: температура температуры
такой: таких
удалять: удаляет
правильный: правильный
доктор: доктор
вод: воду воде вода
карантин: карантин
нужный: нужного
преимущественный: преимущественно
несколько: несколько
питомец: питомца питомец питомцев питомцам
оптимальный: оптимальный
кожный: кожных
подлежать: подлежит
натуральный: натуральных натуральные
благодаря: благодаря
раздражать: раздражает
мы: мы
приучение: приучение
на: на
состав: состав составе состава
тот: тот то том
не: не
использовать: использовать
самостоятельно: самостоятельно
указать: указана указанную укажите
кукурузный: кукурузного
разговаривать: разговаривайте
блестеть: блестящей
содержать: содержит
поздний: позже
но: но
маленький: маленьким
почта: почту
антибактериальный: антибактериальным
щадить: щадящий
вызвать: вызвать
баланс: баланс
внешний: внешних внешний внешними
емкость: емкость емкости
появление: появления появление
длить: для
склонить: склонен
бережный: бережная
начинать: начинать
ватный: ватными
количество: количество
об: об
уровень: уровень
поиграть: поиграть
он: него он
показание: показанием
от: от
кора: кору
способствовать: способствует
избегать: избегайте
попробовать: попробовать
блоха: блох
как: как
внимание: внимание
патогенный: патогенной
все: все всех
воспаление: воспалениями
помогать: помогает помогающие
по: по
отсутствовать: отсутствуют
защитный: защитное
приучать: приучать
безопасный: безопасен
информация: информация
склонный: склонна
достижение: достижения
подготовить: подготовьте
риск: риск
очень: очень
способ: способ
какой: какие
наличие: наличие наличии
переть: при
