волосок: волоски
состоять: состоит
тоже: тоже
кормовой: кормовыми
назначение: назначение
сомнение: сомнения
есть: есть
реалия: реалиях
служить: служит
сквозь: сквозь
происходить: происходит
еще: еще
любить: любимы любящий
лишний: лишней
эффективный: эффективным
этот: эти этой этих
прикрепить: прикрепленные
погода: погоде
важный: важно
протяжение: протяжении
множество: множество
продвигаться: продвигаясь
помощь: помощью
сбор: сбора
отмереть: отмершего отмершие
отлично: отлично
перчатка: перчатками
а: а
сторожевой: сторожевых
бережно: бережно
в: в
содержание: содержания
и: и
к: к
воздух: воздуха
применение: применение
о: о
с: с
она: она
средство: средством
у: у
применять: применять
обогрев: обогревом
шампунь: шампунями
течение: течение
область: области
они: они им них
влажность: влажностью
потенциальный: потенциальных
уже: уже
обеспечить: обеспечит
раз: раза
структура: структура
вы: вы вам
оставить: оставьте
умилять: умиляют
шерстный: шерстный
величество: величества
необходимо: необходимо
небольшой: небольшие
весной: весной
регулярный: регулярном
сегодняшний: сегодняшних
кнопка: кнопку
интернет: интернете
простой: проще
волос: волоса волос
внутренний: внутренними
веселый: веселым
щенок: щенка
регулярность: регулярностью
свое: свое
радовать: радуют
главный: главный
заканчивать: заканчивая
популярный: популярен
влагоотталкивающий: влагоотталкивающее
да: да
также: также
появиться: появится
остевой: остевые остевой
получение: получения
оставлять: оставляя
без: без
перед: перед
шерстить: шерсти
до: до
легко: легко
излишний: излишней
нуждаться: нуждается
головка: головке
вытаскивать: вытаскивают вытаскивает
адрес: адрес
другой: другими других
зря: зря
работа: работы
давать: дает
обожать: обожают
знаменитый: знаменитые
ее: ее
обеспечивать: обеспечивающего обеспечивает
регулярно: регулярно
защищать: защищает
сброситься: сбросится
знать: знаете знать
сущность: сущность
короткий: короткими короткой
рекомендовать: рекомендуем
отзыв: отзывы отзыв
подшерсток: подшерсток подшерстка
постепенно: постепенно
нижний: нижнего
командный: командными
плотный: плотным
оценка: оценки
всегда: всегда
иметь: имеет
свойство: свойство
круглогодичный: круглогодичная
что: что
длина: длине
квартирный: квартирного
собачка: собачки
за: за
тип: тип типа
оценить: оцените
нажать: нажать
перегреваться: перегреваться
ожидать: ожидают
поверхность: поверхности
повреждать: повреждает
часто: часто
верхний: верхнего
зависеть: зависит
несмотря: несмотря
бренд: бренда
если: если
статья: статье
существовать: существует
справляться: справляется
помимо: помимо
хозяин: хозяев
процесс: процесс
желательно: желательно
запатентовать: запатентованный
избыток: избытком
из: из
царапать: царапает
делать: делая
естественный: естественной
среди: среди
их: их
заказ: заказ
меньший: меньшей меньшем
секрет: секрет
покупка: покупкой
подойти: подойдет
жизненно: жизненно
прибор: приборами
связанный: связано
доставлять: доставляет
тело: тела
должен: должна
выпасть: выпавшую
совмещать: совмещать
являться: являются является
здоровый: здоровую
двор: дворе
кто-то: кто-то
животное: животному
собака: собаки собак собака собаку
собирать: собирают
характерный: характерна
чрезмерный: чрезмерной
забота: заботу
стать: стали стать
нужно: нужно
достаточно: достаточно
который: который
убрать: уберут
длительность: длительность
отличный: отличную
это: это этого
пастуший: пастушьей
достойный: достойный
выбрать: выбрать
миловидный: миловидные
вот: вот
сегодня: сегодня
корги: корги
инструмент: инструмент инструмента
такой: такой такая таким
справиться: справиться
жизнь: жизни жизнь
только: только
питомец: питомца питомец
средний: средних
покров: покров
периодический: периодически
линька: линьку линька линькой линьки
ссадина: ссадин
мы: мы
на: на
теплый: тепло
воздействие: воздействий
тот: то
высокоинтеллектуальный: высокоинтеллектуальные
не: не
уход: уход ухода
использовать: использовать используйте
указать: укажите
но: но
почта: почту
относительно: относительно
когда: когда
профилактика: профилактики
внешний: внешних
страдать: страдает
длить: для
категория: категории
ладить: ладят
независимо: независимо
начинать: начиная начинайте
привязать: привязаны
вдоль: вдоль
холодный: холодной
первый: первую первый
интенсивный: интенсивная
он: он
от: от
норма: норме нормой
слабый: слабо
попробовать: попробуйте
примерный: примерный
как: как
лапка: лапками
размер: размеру размера
вычесывание: вычесывание вычесывания
сохранять: сохраняет
условие: условиями
против: против
ваш: вашей ваш
так: так
ответ: ответ
по: по
четвероногий: четвероногие
защитный: защитного
ведь: ведь
сократить: сократить
кто: кто
зубчик: зубчики
спросить: спросите
сократиться: сократится
активный: активные
привыкнуть: привыкли
счастливый: счастливых счастливым
расчесывать: расчесывайте расчесывать
подбираться: подбирается
очень: очень
всеять: всей
самый: самым
проникать: проникает
порода: пород породы
скорый: скорее
способ: способ
добавка: добавками
товар: товар
наличие: наличии
достигать: достигает
быть: были быть будет
вытянутый: вытянутым
переть: при
шерсть: шерстью шерсть
