зимний: зимняя зимнее
происходить: происходит
мочь: могут
этот: этот
со: со
важный: важно
щетка: щеткой
дополнительно: дополнительно
в: в
благотворный: благотворное
кошка: кошек кошки
и: и
стресс: стресс
к: к
можно: можно
подходить: подходящих
о: о
с: с
она: ней она
исследование: исследования
у: у
течение: течение
шампунь: шампуней
во: во
влажность: влажность
обеспечить: обеспечить обеспечьте
раз: раза раз
неряшливый: неряшливый
вы: вы
оставить: оставьте
необходимый: необходимые
расческа: расческу
входить: входили
необходимо: необходимо
визит: визита
обойтись: обойтись
весной: весной
время: время
регулярный: регулярного
щетина: щетиной
длинношерстый: длинношерстых
порой: порой
внутренний: внутренних
обычно: обычно
свое: свои
проблема: проблемы
чтобы: чтобы
рацион: рационы
появиться: появится
получение: получения
носить: носит
без: без
необходимость: необходимости
шерстить: шерсти
мытье: мытье
ежедневный: ежедневное
адрес: адрес
какой-либо: какие-либо
задача: задача
регулярно: регулярно
однако: однако
короткошерстный: короткошерстный
вычесывать: вычесывать
причина: причины
короткий: короткая
отзыв: отзыв
вид: вид
кроме: кроме
подшерсток: подшерстка
один: одного
мастер: мастер
оценка: оценки
сбалансированный: сбалансированные
проветривать: проветривайте
что: что
тип: типу
за: за
оценить: оцените
домашние: домашних
гигиенический: гигиенические
указывать: указывает
неправильный: неправильное
паразит: паразитов
дом: доме
ожидать: ожидают
класс: классов
рукавица: рукавицей
некоторые: некоторых
помочь: помочь
процедура: процедуры
если: если
частый: частыми
выпадение: выпадение выпадения
подвести: подведем
кожа: кожи
наш: наши
ветеринарный: ветеринарному ветеринарного
естественный: естественный
настоящий: настоящей
комфортный: комфортный
сезонный: сезонную сезонной
направить: направленную
качество: качество
заказ: заказ
меню: меню
длинношерстный: длинношерстных
становиться: становится
уменьшение: уменьшение
врач: врача
оказывать: оказывающие
сделать: сделать
различный: различными
назначить: назначит
проживание: проживание
являться: является
жирный: жирные
интенсивность: интенсивности
обратиться: обратитесь
собака: собак собаки
приходиться: приходится
потеря: потеря
который: который
вносить: вносит
любимец: любимцев любимцу любимцем
провести: проведет
это: это этого
поддерживать: поддерживайте
два: два
достойный: достойный
пропустить: пропустить
инструмент: инструменты
случай: случаях
такой: таким такого
справиться: справиться
его: его
иметься: имеются
неприятный: неприятный
жизнь: жизни
несколько: несколько
питомец: питомцу питомцев питомца
средний: средней
отличать: отличать
заражение: заражение
линька: линька линьку линьки линьке
оптимальный: оптимальную
или: или
натуральный: натуральной
мы: мы
на: на
состав: состав
тот: то
не: не
уход: уход уходу
указать: укажите
патологический: патологическая патологический патологическую
маленький: меньше
почта: почту
добавить: добавьте
когда: когда
внешний: внешний
длить: для
обрабатывать: обрабатывайте
количество: количество
обратить: обратите
влияние: влияние
понадобиться: понадобятся понадобится
обильный: обильное
болезнь: болезни
обусловить: обусловлена
он: него ему
состояние: состояния
от: от
итог: итоги
приобрести: приобрести
наблюдаться: наблюдается
как: как
внимание: внимание
все: всего
вычесывание: вычесывания
условие: условиях
ваш: ваша вашей ваш
сдвигаться: сдвигается
по: по
четвероногий: четвероногого
рекомендация: рекомендации
ведь: ведь
кислота: кислоты
где: где
постараться: постарайтесь
потребоваться: потребуется потребуются
опасный: опасные
использование: использованием
способ: способ
высокий: высоких
товар: товар
наличие: наличии
выбирать: выбирайте
быть: быть было
переть: при
шерсть: шерсть
