получение: получения
определение: определения
цена: цене
до: до
написать: напишем
мы: мы
скидка: скидки
на: на
заказ: заказ
адрес: адрес
лапа: лапу
указать: укажите
выгодный: выгодной
почта: почту
когда: когда
таблица: таблице
длить: для
посол: после
в: в
основной: основных
содержание: содержание
измерять: измеряем
и: и
рекомендовать: рекомендуем
отзыв: отзыв
собака: собак собаку собаки
переходить: переходите
определить: определите
оценка: оценки
извинить: извините
размер: размера размер
править: правила
оценить: оцените
оставить: оставьте
ваш: вашей ваш
по: по
ожидать: ожидают
ссылка: ссылке
одежда: одежду одежды
измерение: измерения измерении
обувь: обувь обуви
способ: способ
покупать: покупайте
тереть: три
товар: товар
наличие: наличии
аксессуар: аксессуары
также: также
переть: при
появиться: появится
