частота: частота
день: дня
мерный: мерный
таблетка: таблетки
есть: есть
мама: мама
аптека: аптек
мочь: может можете могли
этот: этими
любимица: любимице
со: со
потомство: потомства потомство
менее: менее
касаться: касается
важный: важно
друг: друг друга
изолировать: изолировать
а: а
в: в
основной: основная
гельминт: гельминты гельминтов
и: и
к: к
летальный: летальному
можно: можно
применение: применению применения
фиксировать: фиксировать
о: о
дать: дать
переносчик: переносчиками
она: нее
с: с
средство: средства средство средств
у: у
течение: течение
область: область
клещ: клещи клещей
они: ими они
отравлять: отравляют
уже: уже
дата: дату
вы: вы
оставить: оставьте
входить: входит
необходимо: необходимо
небольшой: небольшое
употребление: употребление
порой: порой
обычно: обычно
чтобы: чтобы
также: также
здесь: здесь
контактировать: контактировать
появиться: появится
получение: получения
прежде: прежде
следовать: следует
рождение: рождения
предварительно: предварительно
слегка: слегка
зависимость: зависимости
положить: положить
адрес: адрес
другой: другие
представить: представлены
подбирать: подбирать
регулярно: регулярно
однако: однако
закрыть: закрыть
посол: после
период: периоды
часы: часов
рекомендоваться: рекомендуется
читать: читать
причина: причина причины
беременность: беременности
отзыв: отзыв
вид: видов виды
оценка: оценки
что: что чем
мера: мере
будущий: будущая
за: за
оценить: оцените
домашние: домашних
паразит: паразитами паразитов паразиты
котенок: котят котята
рождаться: рождаются
ожидать: ожидающая ожидают
последний: последней
минута: минут
точечный: точечно
часто: часто
некоторые: некоторых
зависеть: зависит
глотательный: глотательное
если: если
укус: укусы
уделить: уделить
любой: любом
ассортимент: ассортименте
желательно: желательно
подвести: подведем
способный: способны
термически: термически
ветеринарный: ветеринарному ветеринарных ветеринарный ветеринарным
серьезный: серьезно
обработать: обработана
удобный: удобны
их: их
контакт: контакт
язык: языка
качество: качестве
через: через
заказ: заказ
пасть: пасть
следить: следить
врач: врачом
грязный: грязной
особенно: особенно
испытывать: испытывает
опасность: опасность
являться: являются
бывать: бывает
животное: животных
защитить: защитить
плацентарный: плацентарный
обратиться: обратиться
малыш: малыши
достаточно: достаточно
который: которыми который которому
поэтому: поэтому
вызывать: вызывает
любимец: любимца любимцев
провести: провести
это: это этом
обработка: обработка обработке обработки
подобрать: подберет
привести: привести
пища: пищу
рост: роста
обнаружить: обнаружить
выбрать: выбранного выбрать
рассказать: расскажем
закупорка: закупорку
пропустить: пропустить
случай: случае
суспензия: суспензии
отмерить: отмерить
жизнедеятельность: жизнедеятельности
познать: познают
неприятный: неприятные
только: только
капля: капли
несколько: несколько нескольких
питомец: питомец питомцев
нельзя: нельзя
улица: улице
заражение: заражение заражения
кожный: кожный
рука: рукой
корень: корень
возраст: возраста
благодаря: благодаря
мы: мы
на: на
необработанный: необработанных
защита: защиты
тот: то
комплект: комплект
не: не
каждый: каждом
указать: укажите
но: но
маленький: маленьких маленький
слизать: слизать
регулировать: регулировать
почта: почту
наноситься: наносятся
несвоевременный: несвоевременная
выпускаться: выпускаются
когда: когда
внешний: внешними внешних
длить: для
обрабатывать: обрабатывать
количество: количествах количество
личинка: личинки
сгрызть: сгрызли
разрешить: разрешенные разрешен
он: ему
даже: даже
от: от
итог: итоги
планироваться: планируется
появляться: появляется
стимулировать: стимулируя
игра: игры
поскольку: поскольку
блоха: блох
как: как
внимание: внимание
размер: размер
препарат: препараты препаратом
глист: глисты глистов
ваш: вашей ваш
так: так
по: по
ведь: ведь
больший: больших
достижение: достижении
опасный: опасным опасны опасных
неделя: недель
подбираться: подбираются
самый: самых
проникать: проникать
способ: способ
забывать: забывайте
товар: товар
наличие: наличии
второе: второго
продукт: продукты продуктов
быть: быть была
активно: активно
