состоять: состоит
протянуть: протяните
приводить: приводит
стандартный: стандартный
фланель: фланели
влагозащитный: влагозащитными
прогулка: прогулки прогулок
еще: еще
любить: любят
снимать: снимаем
лапа: лапы
отвести: отведенное
со: со
важный: важно важен
касаться: касается
бесплатный: бесплатной
натирать: натирала
под: под
прохладный: прохладную
предложить: предложите
пол: пола
а: а
прибавить: прибавьте
в: в
немного: немного
лес: лесу
пункт: пункт
выводить: выводить
и: и
к: к
м: м
о: о
подходить: подходящую
с: с
она: она ней
у: у
течение: течение
определить: определенных
дополнительный: дополнительной дополнительных
они: они
родина: родиной
обеспечить: обеспечат
водитель: водителей
необходимый: необходим
опытный: опытные
расположить: расположены
кормить: кормящие
слишком: слишком
время: время временем
ушко: ушки
натягивать: натягивать
миллиметр: мм
внутренний: внутренней
погладить: погладьте
сильный: сильные
проблема: проблемами
соответствующий: соответствующую
также: также
появиться: появится
город: городов
получение: получения
носить: носить
понравиться: понравившихся
следовать: следует
образовываться: образовываться
прийтись: придется
зависимость: зависимости
постирать: постирать
делаться: делается
воздействовать: воздействуют
чреватый: чревато чреват
комфортно: комфортно
мороз: морозы
климатический: климатическим
подбирать: подбирать
аллергический: аллергическую
однако: однако
слой: слой
себя: собой
короткошерстный: короткошерстная
девочка: девочек
заказать: заказать
рекомендовать: рекомендуем
отзыв: отзыв
постепенно: постепенно
один: одним
оценка: оценки
обязательно: обязательно
иметь: имеет
длина: длину длина
пошив: пошива пошиве
липучка: липучку
оценить: оцените
грязь: грязь
часть: часть
удерживать: удерживают
часто: часто
надеть: надеть наденьте
верхний: верхней
некоторые: некоторых некоторые
помочь: помогут
укус: укусов
плюсовой: плюсовые
мерка: мерки
желательно: желательно
подвести: подведем
кожа: кожу
делать: делает
негативный: негативно негативных
переохлаждение: переохлаждение
комфортный: комфортнее комфортных комфортной
сшить: сшитые
грудной: грудной
качество: качестве качество
похожий: похож
через: через
приучить: приучить
становиться: становится
результат: результате
видимость: видимость
особенно: особенно
должен: должен должна должно должны
поставить: поставьте
окружать: окружающей
оплатить: оплатить
являться: является являются
посыпать: посыпают
бывать: бывают
единый: единый
увеличивать: увеличивайте
нужно: нужно
достаточно: достаточно
обладать: обладает
стать: станет
обилие: обилием
отличный: отличными
нежный: нежную
актуально: актуально
группа: группе
сантиметровый: сантиметровой сантиметровую
провести: провела
это: это этом
прочный: прочный прочной
шиться: шьется
большинство: большинство
ткань: ткани ткань
два: двух
противный: противном
осадка: осадки
взять: возьмете взять
его: его
неприятный: неприятный
жизнь: жизнь
только: только
сантиметр: см
нельзя: нельзя
улица: улицы улицу
твердый: твердую
или: или
приспособить: приспособлены
курточный: курточная
защита: защита защиты
воздействие: воздействий
примерить: примерить
восстановление: восстановления
осадки: осадков
хороший: лучше
много: более
грудь: груди
когда: когда
сжать: сжать
затем: затем
нарушение: нарушению
чего: чего
промокнуть: промокнет
итог: итоги
поскольку: поскольку
примерный: примерное
размер: размера размеры
лапка: лапки
представляться: представляется
ваш: вашей ваш
так: так
светоотражающий: светоотражающие
французский: французский
присутствовать: присутствует
четвероногий: четвероногого четвероногий четвероногим четвероногому
ведь: ведь
где: где
основание: основания
активный: активным
постараться: постарайтесь
шов: швы
узкий: узкий
привыкнуть: привыкнет
самый: самых самый самую
материал: материала материалы
товар: товар
выбирать: выбирая выбирайте выбираем
быть: быть было будет
шерсть: шерсть
вывести: вывести
тоже: тоже
лента: ленту
назначение: назначение
есть: есть
представлять: представляет
зимний: зимний зимних
внимательно: внимательно
мочь: может могут можете
этот: эти этот
сам: самой
объем: объем
четыре: четыре
погода: погоду
вирусный: вирусным
издавать: издавать
экипировка: экипировка
основной: основные
можно: можно
дать: данной
действовать: действует
немецкий: немецкая
снег: снегом
элемент: элемент элементы
минимальный: минимальные
использоваться: используется
производитель: производитель производителей
во: во
уже: уже
снижение: снижением снижению
того: того
вы: вы вас
оставить: оставьте
китайский: китайская
отвлечь: отвлечь
необходимо: необходимо
словом: словом
простой: проще
химический: химическими
порой: порой
пройтись: пройтись
популярный: популярных популярный
чтобы: чтобы
здесь: здесь
капюшон: капюшон
консультант: консультанты
соблюсти: соблюсти
услуга: услуга
дома: дома
записать: запишите
до: до
комбинезон: комбинезон комбинезонов комбинезона комбинезоне комбинезоны комбинезону
помнить: помнить
вооружиться: вооружитесь
адрес: адрес
запястье: запястья
клетка: клетки
зоомагазин: зоомагазин
ее: ее
пожилой: пожилые
пригодиться: пригодится
посол: после
задевать: задевает
период: период
защищать: защищать защищающий
жаркий: жаркие
вид: видов вид
отопление: отопления
вымыть: вымыть
бесшерстный: бесшерстных бесшерстная
плотный: плотной
всегда: всегда
деликатный: деликатном
надежно: надежно
выздоровление: выздоровления
демисезонный: демисезонных демисезонный
снять: снять снимите
что: что
подверженный: подвержен
погодный: погодные
тип: тип
за: за
детская: детской
ограничиваться: ограничивается
домашний: домашний
ожидать: ожидают
хлопчатобумажный: хлопчатобумажной
лакомство: лакомством
если: если
успокоить: успокоит
любой: любую
дождевик: дождевик дождевиков
отличаться: отличается
сбивать: сбивать
из: из
изделие: изделие изделиях изделия
наш: наших нашим
обстановка: обстановке
торчать: торчащих
удобный: удобную
их: их
бактериальный: бактериальным
многие: многих
насекомое: насекомых
контакт: контакт
хвост: хвоста
заказ: заказ
похвалить: похвалите
длинношерстный: длинношерстных
угостить: угостите
сдавливать: сдавливать
сделать: сделать
здоровье: здоровьем
тело: теле
обращать: обращайте
влажный: влажным
испытывать: испытывать
актуальный: актуален
удлиненный: удлиненные
движение: движения
защитить: защитит защитить
нюанс: нюанс
йоркширский: йоркширский
собака: собаки собак собакой собакам собаку
болтаться: болтаться
беременная: беременные
который: который которыми которые которых которой
поэтому: поэтому
длительность: длительность
холка: холки
крупный: крупных
любимец: любимца любимцы
подобрать: подобрать
ли: ли
привести: привести
стеснять: стеснять
выбрать: выбрать
рассказать: расскажем
случай: случаях случае
сразу: сразу
температура: температуры
такой: такой такими такое
примерка: примерки примерку
несколько: несколько
питомец: питомцев питомца питомцу питомец
место: мест
горазд: гораздо
бостон: бостон
широкий: широкий широкой широкую
оксфорд: оксфорд
мы: мы
на: на
приучение: приучение
тот: тот тому то
проезжать: проезжающих
не: не
выбор: выборе
каждый: каждой
передний: передними передних
ни: ни
указать: укажите
измерить: измерьте измерить
частить: части
утеплить: утепленная
но: но
почта: почту
вызвать: вызвать
неустойчивый: неустойчивую
ношение: ношение ношения ношению
прогуливаться: прогуливаться
длить: для
начинать: начинать
модель: моделей модель
обратить: обратите
нет: нет
дождь: дождя
он: него он ему
предлагать: предлагают
даже: даже
от: от
парка: парку
бегать: бегать
попробовать: попробовать
обхват: обхват
как: как
внимание: внимание
все: все
возможность: возможности
по: по
непромокаемый: непромокаемой
осмотреть: осмотрите
опасный: опасными
немой: нем
риск: риска
одежда: одежда одежды одежду одежде
молния: молнии
порода: породы пород
способ: способ
толщина: толщину толщиной
какой: какими
наличие: наличие наличии
яркий: ярких
переть: при
