долгий: долгой
подкладка: подкладке
специальный: специальные
акрил: акрила
новый: новых нового новейшим новыми новым
веяние: веяний
еще: еще
учет: учетом
прогулка: прогулок прогулки
любить: любят
снимать: снимать
лапа: лапы лапах
со: со
важный: важно
пойти: пойти
чувствоваться: чувствуются
живот: живот
накидка: накидках
драгоценный: драгоценными
пол: полу
а: а
человек: людей
производство: производством
в: в
и: и
водонепроницаемый: водонепроницаемой
качественный: качественных качественные
к: к
о: о
подходить: подходящую подходят
плотно: плотно
с: с
она: она
у: у
они: них они ним им
дополнительный: дополнительную
владелец: владельцев владелец
ветер: ветер
необходимый: необходима
теперь: теперь
портной: портных
входить: входит
рассмотреть: рассмотрим
препятствовать: препятствуют
расположить: расположены
быстро: быстро
время: время
вечеринка: вечеринки
веселый: веселой
подробно: подробно
прорезиненный: прорезиненной
пополняться: пополняется
составлять: составляющей
обморозить: обморозила
максимально: максимально
заботиться: заботиться заботится
также: также
появиться: появился появилась появится
получение: получения
мода: мода моды
носить: носить
понравиться: понравился понравится
следовать: следовать следуйте
удобно: удобно
легко: легко
надевать: надевала надевать надевайте
сначала: сначала
собачий: собачья собачьей
давить: давят
изменение: изменения
вечерний: вечерними
сидеть: сидят сидеть
комфортно: комфортно
однажды: однажды
обеспечивать: обеспечивающие
дополнить: дополнены
слой: слои
себя: себе собой себя
платье: платья
короткошерстный: короткошерстных
девочка: девочек
предназначить: предназначены
осенить: осени
тяжелый: тяжелом
попона: попоны
рекомендовать: рекомендуем
крепкий: крепко
отзыв: отзыв
потребность: потребности
городской: городской
приятный: приятный приятные
купить: купите
один: один
оценка: оценки
сковывать: сковывают
иметь: имеют
британский: британском
полностью: полностью
совет: советы
интересный: интересными
физиологический: физиологических
дышать: дышащий дышащие дышащей дышащего
богатый: богатая
собачка: собачками
липучка: липучке
нить: нити
оценить: оценят оцените
практический: практически
последний: последним
ссылка: ссылке
сторона: стороне
дорогой: дорогих
инструкция: инструкции
наслаждаться: наслаждаться
функциональный: функциональным функциональному функциональные
эпоха: эпохи
помочь: помогут
шарф: шарфы шарфов
бренд: бренды бренда бренд брендов
обувь: обувь
процесс: процесс
избежать: избежать
потерять: потеряете
разрабатываться: разрабатывается
среда: среды
среди: среди
сшить: сшить
скидка: скидки
крыться: кроется
качество: качества качество
серый: серых
воспользоваться: воспользуйтесь
приучить: приучат
надеваться: надеваются
меняться: меняющихся
выгодный: выгодной
климат: климата
опыт: опыт
комикс: комиксами
выглядеть: выглядеть
большой: большой
заказывать: заказывать
праздничный: праздничных
знатный: знатные
посыпать: посыпают
курточка: курточке
из-за: из-за
новогодний: новогодней
временить: времени
хотеть: хочет
крыть: крою
японский: японского
стать: стала стать
устроить: устроить
пуговица: пуговицах
побудить: побудило
отличный: отличный отличным
замерзнуть: замерзнут
нежный: нежных
костюмчик: костюмчик
штанина: штанин
это: это этого этом
дизайнер: дизайнера дизайнер
прочный: прочно
шиться: шилась
гулять: гуляющих
шапочка: шапочки шапочек
ошейник: ошейники
удобство: удобства
взять: взять
неприятный: неприятной
только: только
двойной: двойная
жизнь: жизни
покупать: покупайте покупать покупаете
скользить: скользить скользят
улица: улицах улице
или: или
любовь: любовь
идеально: идеально
чаща: чаще
точно: точно
защита: защита защиты
теплый: теплых тепло теплые теплой
считать: считают
воздействие: воздействия
быстрый: быстрым
хороший: лучше
свитер: свитеры свитеров
много: много
относительно: относительно
когда: когда
учитывать: учитывайте
дурной: дурным
нововведение: нововведений
раут: рауты
действие: действия
забавный: забавные
продолжать: продолжает
первый: первый
желание: желание
промокнуть: промокнет промокнут
садиться: садятся
обязательный: обязательное
носок: носков носки
выполнить: выполнены
дизайн: дизайну дизайне
компания: компания
произвести: произведены
уютный: уютных
ориентироваться: ориентируйтесь
лапка: лапки
симпатичный: симпатичных
размер: размерах
тканый: тканей
ваш: вашего вашему ваши ваш вашем вашей
жилетка: жилетки
так: так
светоотражающий: светоотражающим светоотражающими светоотражающие
лужа: лужам
там: там
резиновый: резиновых
рекомендация: рекомендациям
голова: голову головах
ведь: ведь
больший: большей
где: где
кто: кто
куртка: куртки курток
считаться: считалось
дальнейший: дальнейшем
попадание: попадания
позволять: позволяли позволяя позволяют
зафиксировать: зафиксировать
самый: самых самым
эволюция: эволюции
материал: материал материалов
порезвиться: порезвиться
товар: товары товар
выбирать: выбирали выбирайте
быть: была был будет будут быть
шерсть: шерсть
тоже: тоже
терять: теряет
носочек: носочков носочки
приготовить: приготовить
темный: темное
есть: есть
приятно: приятно
зимний: зимних зимние
долговечный: долговечный
разработать: разработана разработаны
мочь: может можете могут
этот: этой
сам: самих самим сама
четыре: четыре
мокрый: мокрый
погода: погода
отлично: отлично
осенний: осенних
изготовить: изготовлены изготовлена
толстый: толстая
можно: можно
фиксировать: фиксируют фиксирует
дать: даст
снег: снег снега
попрыгать: попрыгать
позволить: позволят
производитель: производителей
стандарт: стандартам
во: во
влажность: влажность
прыгать: прыгать
раз: раз
того: того
вы: вы
оставить: оставьте
российский: российском
проводить: проводить
скольжение: скольжения
чувствовать: чувствовать
россия: россии
хлопок: хлопка
свой: свой своей
основать: основал
розовый: розовых
свое: своих
радовать: радовать
популярный: популярные
чтобы: чтобы
эстетический: эстетической
капюшон: капюшонами
законодательница: законодательницей
меховой: меховыми меховым
перед: перед
утягивать: утягивающие
до: до
комбинезон: комбинезоны комбинезонов
многочисленный: многочисленные
зародиться: зародилась
особенность: особенностей особенности
страшный: страшны
мытье: мытье
адрес: адрес
представить: представлен представлены
другой: другие
отпугивать: отпугивающей
прийти: прийти
зоомагазин: зоомагазинах зоомагазине
давать: давая
ботинок: ботинок ботинки ботинках
ее: ее
регулярно: регулярно
дождливый: дождливую дождливая
застревать: застревать
посол: после
защищать: защищает защищают
период: период периода
королев: королева
число: числе
неожиданно: неожиданно
знать: знает
причина: причина
вселенная: вселенной
старый: старейших
темнота: темноте
короткий: короткими
вид: виды виде
производиться: производятся
же: же
влага: влаги
подошва: подошве подошвой подошва
польза: пользе
плотный: плотной
одевание: одевания
надежно: надежно
светский: светские светское
мраморный: мраморном
что: что чему
погодный: погодных погодные
закрывать: закрывают
стильный: стильные стильно стильном стильными
тип: типом
наряжать: наряжайте
ожидать: ожидают
изготавливаться: изготавливаются
костюм: костюм
существовать: существует
статья: статье
если: если
современный: современной современному
повод: поводом
захотеть: захотели
ассортимент: ассортименте
дождевик: дождевики
любой: любых любого любым
смелый: смело
честь: честь
пушистый: пушистые
оригинальный: оригинальный оригинальные
из: из
изделие: изделия
ходить: ходили
наш: нашего нашей
дама: дамы
удобный: удобному удобным удобный удобные удобной удобных
их: их
сюрприз: сюрприз
заказ: заказ
резвиться: резвиться
зимой: зимой
игрушка: игрушки
сервис: сервисом
ножка: ножками
длинношерстный: длинношерстных
посетитель: посетители
около: около
застежка: застежки
сдавливать: сдавливая
тщательно: тщательно
ворот: вороты
сделать: сделать
родоначальник: родоначальником
заметить: заметить
заниматься: занимались занимаются
тело: телу тело
обращать: обращайте
толстовка: толстовок толстовки
разный: разные разных
актуальный: актуальная
шить: шить
движение: движений
защитить: защитит защитят
собака: собак собаки собакам собака собаку
продукция: продукция
завоевать: завоевала
решить: решил
постоянный: постоянные
который: которому котором которыми которая которые которым которого который
вывод: выводы
поэтому: поэтому
снимка: снимки
любимец: любимца любимцы любимец
неодетый: неодетым
футболка: футболки
рассказать: расскажем
вот: вот
претерпеть: претерпела
хорошо: хорошо
случай: случаи
покупатель: покупателей
такой: такую такой
резинка: резинкам
примерка: примерка
создание: создании
надежный: надежные
питомец: питомцем питомца питомцу питомцев питомец питомцах питомцы
отдельно: отдельно
шапка: шапки
необычный: необычными
тенденция: тенденций тенденциям
благодаря: благодаря
мы: мы
на: на
состав: состав
тот: то тех том
стирка: стирки
потеряться: потеряются
комплект: комплекты
не: не
выбор: выбор выборе выбору
тузик: тузик
каждый: каждом каждого
эластичный: эластичные
шлейка: шлейкой
ни: ни
указать: укажите
измерить: измерьте
миска: миски
модный: модный модных модная модным модной
любитель: любителям
но: но
почта: почту
история: история
появление: появления
длить: для
модель: модели моделей
об: об
холодный: холодно
согласно: согласно
влагостойкий: влагостойкой
дождь: дождя дождь
он: него он ему
даже: даже
переходить: переходите
от: от
вдохновить: вдохновленный
холод: холода
причинять: причиняя
как: как
внимание: внимание
все: все всем всех
условие: условиях условия
по: по
непромокаемый: непромокаемой
плохой: плохой
выпускать: выпускающий выпускает
постоянно: постоянно
низ: низ
одежда: одежды одежду одежда одеждой одежде
порода: пород
упасть: упасть упадет
расцветка: расцветок
способ: способ
высокий: высокая высшие
линейка: линейка линейки
какой: какие какой
наличие: наличии
аксессуар: аксессуары аксессуар
яркий: ярких яркому яркие яркими
мех: мехом
утренний: утренними
переть: при
заранее: заранее
