исполинский: исполинский исполинских
поездка: поездок
витамин: витамины
специальный: специальные специально
новый: новый
примечательный: примечательны
образ: образом
ухо: ушей
служить: служат
невероятный: невероятной
учет: учетом
еще: еще
любить: любят
физический: физической физическую
обзор: обзор
лапа: лапами лапы лапах лапой
со: со
касаться: касается
важный: важные важно
пойти: пойдет
доверие: доверие
встретить: встретить
помощь: помощью
кубический: кубической
а: а
в: в
е: е
немного: немного
содержание: содержание
и: и
к: к
о: о
подходить: подходящих
с: с
средство: средства
у: у
применять: применяя
определить: определенной определенное
шампунь: шампунь
запах: запахов запаха
они: они них ими им
дополнительный: дополнительным
родина: родиной
владелец: владельцы
вариант: варианты
кисточка: кисточками кисточки
гигиена: гигиену
необходимый: необходимое необходимые необходимых необходимы
весьма: весьма
входить: входящие
кормить: кормите кормить
макроэлемент: макроэлементов
время: время
ушко: ушках
забыть: забудьте
кондиционер: кондиционер
мощный: мощный мощную
сильный: сильно
составлять: составлять составляют составляет
также: также
корма: корм корме кормах корма
член: членам членами
появиться: появившиеся появилась появился появится
неприхотливый: неприхотливая
город: город
получение: получения
поддержание: поддержания
понравиться: понравятся
следовать: следует
комплексный: комплексного
легко: легко
неиссякаемый: неиссякаемый
функционирование: функционирования
вылизывать: вылизывать
прийтись: придется придутся
зубной: зубной
употреблять: употреблять
находиться: находиться
трепетно: трепетно
света: свет
комфортно: комфортно
требовать: требуют
обожать: обожающий обожает обожают
лоток: лотка лоток
выставка: выставках
подбирать: подбирайте
редкий: редкими
однако: однако
порядок: порядка
предназначить: предназначенные
завод: завод
система: системы
скрещивание: скрещивания
далекий: дальше
полосатый: полосатый полосатой
рекомендовать: рекомендуем
крепкий: крепкие
отзыв: отзыв
хищник: хищнику
очаровательный: очаровательные
поддержка: поддержка поддержку
один: одного
оценка: оценки
заводной: заводные
иметь: имеет
интересный: интересные
индейка: индейкой индейка
длина: длина длины длине длину
мера: мере
пользоваться: пользоваться
оценить: оцените
лишь: лишь
семейство: семейства
практический: практически
класс: классов
столетие: столетия
активность: активности активность
часто: часто
некоторые: некоторые
помочь: помогут
частый: частыми
усач: усач усачей
подрасти: подросшего
помимо: помимо
туловище: туловища
привлекательный: привлекательный
природный: природного природный
проявить: проявит
избежать: избежать
потерять: потеряла
основа: основу
ловкий: ловких
способный: способны
кожа: кожи
волосяной: волосяных
делать: делать
курица: курицей курица
белка: белки белка
среди: среди
клетчатка: клетчатки клетчатка
комфортный: комфортный
через: через
метис: метисы
нрав: нравом
обустроить: обустроить
взрослый: взрослом взрослых
врач: врача
соединить: соединенные
превышать: превышать
результат: результате
коготь: когти
особенно: особенно
команда: команду
встречаться: встречалось
должен: должно должна
являться: является
бывать: бывают
из-за: из-за
животное: животные животного
гигантский: гигантских
чистить: чистите
ничего: ничего
предок: предками
насытить: насытят
половина: половине
расщепление: расщеплению
стать: стали стать станет
достаточно: достаточно
нужно: нужно
обладать: обладающих
бить: бьет
инулин: инулина
квадратный: квадратных
возможно: возможно
нежный: нежных нежные
это: это этом
обработка: обработка
поддерживать: поддерживать поддерживайте поддерживая
большинство: большинства большинство
равный: равна равен
слово: слова
вкус: вкусу
сустав: суставов суставы
еда: еды еду
два: две
зацепить: зацепить
прочность: прочность
привлекать: привлекают
взять: взять
опираться: опираясь
кот: кот коты
его: его
рекордсмен: рекордсмен
гигант: гиганты гигантов
ломать: ломать
неприятный: неприятного
только: только
двойной: двойными
жизнь: жизни
брызгаться: брызгаться
дезодорант: дезодорант
средний: среднем
покров: покрова
ароматизатор: ароматизаторов
держать: держать
периодический: периодически
линька: линьки
или: или
отличие: отличие
ненавязчивый: ненавязчивы
возраст: возрасте
относиться: относится
особо: особо
габарит: габариты
теплый: теплый
минимум: минимум
уход: ухода
почему: почему
особый: особом особого
много: много более
внушительный: внушительные
добавить: добавить
когда: когда
играть: играть
вкусный: вкусной
профилактика: профилактики профилактика
болезный: болезней
обычный: обычного обычной
спутник: спутник
общий: общий
продолжать: продолжает
первый: первый первая
вещество: веществ
состояние: состояния
норма: нормы
мурлыка: мурлыки мурлык
ошибка: ошибка
приобрести: приобрести приобретите
происхождение: происхождения
искусственный: искусственных
мягкий: мягкий мягкого мягким
стимулировать: стимулирует
поскольку: поскольку
произвести: произвел
гороховый: гороховая
специализированный: специализированный
размер: размеры размер
высота: высота
именно: именно
ваш: вашем вашего вашему вашей ваш
ротовой: ротовой
общество: обществе
так: так
подвижной: подвижные
генный: генная
четвероногий: четвероногие четвероногого четвероногому
рекомендация: рекомендации
больший: больших большей
перевести: перевести
постараться: постараться
активный: активной
считаться: считается
гиннес: гиннеса
использование: использованием
самый: самыми самым самые
допустимый: допустимых
добавка: добавки
чувствительный: чувствительной
товар: товар
выбирать: выбирая выбирать
быть: были была быть будут будет
миролюбивый: миролюбивые
шерсть: шерсть
отсюда: отсюда
отказывать: отказывайте
кун: куна
добродушный: добродушным
ген: ген
есть: есть
запоминать: запоминают
пластик: пластика
разработать: разработан
ряд: рядом
незнакомец: незнакомцу
мочь: может могут можете
попадать: попадает
выполнять: выполнять
этот: эти этих этой
из-под: из-под
сам: сам самого
сердце: сердца
озорной: озорной
кран: крана
стричь: стричь
основной: основная
иммунитет: иммунитет
кошка: кошка кошек кошки кошкам
характер: характер характером
можно: можно
сравнивать: сравнивают
дать: данной
почтить: почти
преодолевать: преодолевать
ценить: ценят
комочек: комочков
во: во
кошачий: кошачьего кошачьих
готовый: готовый
углевод: углеводов
уже: уже
снижение: снижения
раз: раз
цвет: цвет
суточный: суточной суточного
вы: вы вас вами
оставить: оставьте
расческа: расчески
образование: образования
проводить: проводите
аборигенный: аборигенными
необходимо: необходимо
сердечно-сосудистый: сердечно-сосудистой
речь: речь
просто: просто
версия: версия
адаптировать: адаптировано
простой: проще
видимо: видимо
порой: порой
шесть: шесть
рекорд: рекордов
свой: своей свою
основать: основана
буквальный: буквально
экстракт: экстракт
свое: своих своим
тем: тем
чтобы: чтобы
получиться: получится
густой: густой
аминокислота: аминокислота аминокислот
здесь: здесь
рацион: рациона рационами рационов
энергия: энергия
проведение: проведения
дикий: диким
без: без
гарантировать: гарантирует
необходимость: необходимости
дома: дома
шерстить: шерсти
схожесть: схожести
американский: американский
до: до
штат: штаты
нуждаться: нуждается
представитель: представитель представителей представители представителю представителя
мясной: мясных
особенность: особенностей
ежедневный: ежедневного ежедневном
адрес: адрес
другой: другие другая другими
чистка: чистки
работа: работе
европа: европе
обладатель: обладателей
давать: даете давайте
побуждать: побуждает
ее: ее
пригодиться: пригодится пригодятся
регулярно: регулярно
сочетание: сочетание
посол: после
питание: питанием
сухой: сухой
период: период
вычесывать: вычесывайте
лежак: лежак
кличка: кличке
сторониться: сторонятся
факт: факты
ассоциация: ассоциация
контроль: контроль
ласковый: ласковые
вид: вид
же: же
ингредиент: ингредиентов ингредиент
сбалансированный: сбалансированный сбалансированное
купать: купать купайте
мраморный: мраморный
разбрызгивать: разбрызгивая
что: что чем
эксперт: эксперты
антиоксидант: антиоксиданты
посуда: посуда
тип: тип типов типу
за: за
лосьон: лосьоне лосьоны
мэн: мэн
война: войны
паразит: паразитов
удовольствие: удовольствием
котенок: котенок
форма: формы форма
звать: звали
ожидать: ожидают
рукавица: рукавица
залог: залогом
лакомство: лакомств лакомства
изготавливаться: изготавливаются
процедура: процедуре процедур
если: если
схватить: схватить
современный: современных современной
хозяин: хозяином
эффектный: эффектный
бортик: бортиком
любой: любая
отличаться: отличаются
пушистый: пушистые пушистому
организм: организм
из: из
сводиться: сводится
мировой: мировой
наш: наши
красота: красоты
ответить: ответить
ветеринарный: ветеринарного
естественный: естественное
противовоспалительный: противовоспалительным
ранний: ранних
подставка: подставке
бурый: бурые
настоящий: настоящий
их: их
компонент: компоненты
хвост: хвоста хвост
язык: язык
заказ: заказ
зачастую: зачастую
игрушка: игрушку игрушки
длинношерстный: длинношерстные длинношерстных
одарять: одаряет
уменьшение: уменьшения
посещать: посещайте
омег: омега
оказывать: оказывают
тщательно: тщательно
родоначальник: родоначальниками
мочекаменный: мочекаменной
енотовый: енотовый енотовая енотовые енотовой енотовым енотовых
здоровье: здоровья здоровье
обращать: обращайте
влажный: влажный
разный: разными
верный: верные
здоровый: здоровой здорового
жирный: жирные жирных
милая: милые
ежедневно: ежедневно
год: годах
кг: кг
лосось: лососем
собака: собаками
житься: жилось
ко: ко
завоевать: завоевать
передвигаться: передвигаться
минеральный: минеральных
прекрасно: прекрасно
который: которые который которая которым
вывод: вывод выводы
ухаживать: ухаживать
поэтому: поэтому
выведение: выведению выведение
крупный: крупный крупному крупных крупные
награда: наградой
любимец: любимцев любимцу любимца
диетический: диетической диетические
вылизывание: вылизывания
прибыть: прибыли
выбрать: выбрать
поддаваться: поддаются
рассказать: расскажем
закупорка: закупорку
повышенный: повышенного
инструмент: инструменты
находить: находят
такой: такого такая таким
вместе: вместе
палец: пальцев
вод: воду
текстильный: текстильные
несколько: несколько
питомец: питомца питомцу питомцев
начало: началу
предпочитать: предпочитает предпочитают
оптимальный: оптимальный оптимальным оптимальное
кожный: кожных кожного
блистать: блистал
рука: руками
горазд: гораздо
душ: душе
бостон: бостоне
отдых: отдых
мы: мы
крайне: крайне
крокет: крокеты
на: на
состав: составе состав
совершенно: совершенно
водный: водных
тот: то
роскошный: роскошная
глаз: глаз
комплекс: комплекс
не: не
разгрызать: разгрызать
преданный: преданные
указать: укажите
миска: мисок миски
блестеть: блестящей
содержать: содержащий
усатый: усатому усатого усатых
любитель: любителей
но: но
поздний: позже
почта: почту
антибактериальный: антибактериальным
советовать: советуем
вызвать: вызвать
история: истории
внешний: внешний
длить: для
обрабатывать: обрабатывайте
ладить: ладят
количество: количество количествах количества
содержаться: содержаться
модель: модели
питательный: питательный
уровень: уровень
великан: великаны
продолжительность: продолжительность
понадобиться: понадобятся
приблизительно: приблизительно
нет: нет
зачерпывать: зачерпывая
название: название
он: ему него он
семья: семьи
даже: даже
от: от
желудок: желудок
крушить: крушить
официальный: официальная
придерживаться: придерживаться
длинный: длинная длинной
способствовать: способствует
как: как
первое: первыми
внимание: внимание внимания
все: всего все всем всех
низкий: низкий
челюсть: челюстей
возможность: возможность
отвечать: отвечают
по: по
устойчивый: устойчивые
предотвращение: предотвращения
кислота: кислоты кислот
приучать: приучать
информация: информация
юкка: юкка юкки
подготовить: подготовить
соотношение: соотношению
точность: точностью
очень: очень
тигровый: тигровый
порода: породы порода
улучшение: улучшения
способ: способ
высокий: высоких высокого высокое
нью-йорк: нью-йорке
наличие: наличие наличии
произойти: произошло
достигать: достигает
проверить: проверить
активно: активно
переносок: переноски переноска
второй: второй
источник: источник источником
книга: книги
переть: при
