аквариумный: аквариумной аквариумные аквариумных
приводить: приводит
витамин: витаминами
налет: налета
терять: теряет
дозировка: дозировке
служить: служат
выполнять: выполняют
строительный: строительным
мочь: могут может
месяц: месяц
литровый: литров
воды: воды
калия: калия калий
этот: этих
хелатный: хелатной
важный: важнейшие
юридический: юридический
выделять: выделяют выделяет
а: а
дополнительно: дополнительно
сохранить: сохранить
в: в
концентрация: концентрация
и: и
живой: живые
дырочка: дырочки
к: к
о: о
вероятность: вероятность
она: она
с: с
у: у
нехватка: нехватка нехватку
смочь: сможет
использоваться: используется
они: они им
во: во
обеспечить: обеспечит
базовый: базовое базового
традиционный: традиционного
раз: раз
цвет: цвет
оставить: оставьте
необходимый: необходима необходимых
баллонный: баллонных
препятствовать: препятствует
время: время
быстро: быстро
растение: растения растение растениям
регулярный: регулярного
снижать: снижают
внесение: внесения
кондиционер: кондиционер
ооо: ооо
капризный: капризных
разложение: разложения
тем: тем
заботиться: заботится
чтобы: чтобы
также: также
появиться: появится
компенсировать: компенсируют
получение: получения
насыщение: насыщения
без: без
листовой: листовых
необходимость: необходимости
светло-зеленый: светло-зеленый
особенность: особенностями
мелкий: мелкие
адрес: адрес
снабдить: снабдите
отложение: отложению
симптом: симптомами
биологический: биологического
оставаться: остаются
обеспечивать: обеспечивая
требоваться: требуется
однако: однако
ход: ходе
счет: счет
офис: офис
украшение: украшение
система: систем
еженедельно: еженедельно
рекомендовать: рекомендуем
отзыв: отзыв
вид: видам вид
усваиваться: усваиваться
доступно: доступно
один: один
оценка: оценки
иметь: имеет
что: чем что
светлый: светлое
длительный: длительное
за: за
расчет: расчета
оценить: оцените
рыбка: рыбок
замедление: замедлению
уменьшать: уменьшают
ожидать: ожидают
московский: московская
зачем: зачем
часто: часто
залог: залогом
некоторые: некоторых
помочь: поможет
растенье: растений
способность: способность
из: из
удобрение: удобрение удобрения
естественный: естественный
углекислый: углекислый углекислого углекислым
их: их
разобрать: разберем
компонент: компоненты
фон: фоном
заказ: заказ
жизненно: жизненно
водорослевый: водорослевым
превышать: превышает
около: около
углерод: углерода
обогащать: обогащает
сделать: сделать
связанный: связано
различный: различных
влиять: влияет
должен: должна
являться: является являются
здоровый: здорового здоровый здоровыми
желтоватый: желтоватый
жидкий: жидкий
нормально: нормально
известковый: известкового
насытить: насыщенный
вноситься: вносится
нужно: нужно
который: которого которая который
поэтому: поэтому
расход: расход
вносить: вносить
это: это этом этого
пугливый: пугливым
водопроводный: водопроводной
рост: роста рост
дефицит: дефицита
газ: газ газа газом
случай: случае
стабильность: стабильности
его: его
доступный: доступными
красивый: красивый
осаждать: осаждая
только: только
правильный: правильный
конкурент: конкурент
вод: воде воду
поддерживаться: поддерживаться
или: или
водоросль: водорослей
отличие: отличие
благодаря: благодаря
мы: мы
фотосинтез: фотосинтеза
чаща: чаще
на: на
комплекс: комплекс
не: не
уход: уход
использовать: использовать
указать: укажите
расти: растущие
содержать: содержит
аквариум: аквариумах аквариуме
почта: почту
когда: когда
профилактика: профилактики
значит: значит
страдать: страдают
длить: для
укрытие: укрытием
количество: количество количеством
соль: солей
составить: составит
усвоение: усвоения
противоводорослевый: противоводорослевых
нет: нет
развитие: развития
дополнение: дополнение
лист: листьях листьев листья
даже: даже
от: от
искусственный: искусственного
железо: железо железа
как: как
вернуть: вернуть
все: всем
препарат: препарат
ваш: вашей ваш
больший: большим больше
поглощаться: поглощается
активный: активный
обогащение: обогащения
способ: способа способ
высокий: высшие
какой: какие
товар: товар
наличие: наличии
быть: были быть
яркий: яркими
углекислота: углекислота углекислоты
активно: активно
источник: источником источник
переть: при
