лауреат: лауреатом
долгий: долгой
специальный: специальный
математический: математические
собаковод: собаководы
новый: новой
день: дня
образ: образом
забрать: забрать
найти: найти
служить: служат служившей
происходить: происходит
еще: еще
любить: любимую любимой
подопечный: подопечных
ребенок: детей детьми
вокруг: вокруг
лапа: лап лапы
отвести: отведите
со: со
важный: важных важно
чествовать: чествуют
помощь: помощи помощь
пол: пол
человек: люди человеку людей людям людьми человека
а: а
отмечаться: отмечается
в: в
выводить: выводят
и: и
к: к
о: о
с: с
сейчас: сейчас
средство: средств
у: у
применять: применяют
теория: теорий
организовывать: организовывает
они: они
владелец: владельцы владельцев
вольер: вольеры
вариант: вариантов
мир: мире миру
пройти: пройти
необходимый: необходимых
разъяснительный: разъяснительные
проект: проект проекты проекту проекте
время: времен время временем
сегодняшний: сегодняшний сегодняшние
единственный: единственные
социальный: социальных социальную социальные
оон: оон
праздновать: празднуют
сильный: сильно
подарок: подарков
проблема: проблемам
главный: главная
присоединиться: присоединиться
заботиться: заботится
порадовать: порадовать
соответствующе: соответствующе
также: также
член: члены
появиться: появится
подать: подали
долговременный: долговременная
получение: получения
следовать: следовать
написать: написал
оптимист: оптимисты
построить: построили
начаться: началось
собачий: собачий собачьих
добрый: доброе
австралия: австралии
задача: задачи задача
хотя: хотя
однако: однако
благотворительный: благотворительном
ассоциативный: ассоциативная
оформить: оформить
тяжелый: тяжелыми
древние: древние
рекомендовать: рекомендуем
отзыв: отзыв
июнь: июне
художник: художнику
хвостатый: хвостатым
поддержка: поддержке поддержку
родиться: родился
один: одни
оценка: оценкам оценки
интересный: интересные
нос: носов
оценить: оцените
последний: последние
япония: японии
преобладать: преобладает
минута: минут
некоторые: некоторые
помочь: помогли помочь
июль: июля
суметь: сумели
способность: способностями
инициатор: инициатор
говорить: говорить
ошибочно: ошибочно
белка: белка
среди: среди
комфортный: комфортной
католик: католиков
через: через
сопоставить: сопоставим
различать: различают
официально: официально
священный: священными
команда: команда
выделяться: выделяется
являться: являются
бывать: бывают
документ: документы
проводиться: проводятся
животное: животному животных животными
единый: единого
предок: предком предков
хотеть: хотели
решать: решать
стать: стали стал
достаточно: достаточно
устроить: устройте
медицинский: медицинскую
разновидность: разновидность
обучение: обучение
питаться: питались
совместный: совместную
провести: провели
переносить: переносят
это: это этого этом
умный: умных
слово: слов
ограничить: ограниченными
привлекать: привлекает
взять: взяла взять
его: его
спасательный: спасательных
жизнь: жизни жизнь
только: только
брат: братьям
вероятный: вероятнее
овчарка: овчарке
привлечь: привлечь привлекла привлекли
тапочки: тапочки
улица: улицу
троп: тропе
или: или
любовь: любви
умственный: умственными
защита: защиты
считать: считать
регистрация: регистрации
гормон: гормон
общение: общении
уход: уходу
много: более много
всевозможный: всевозможные
когда: когда
вкусный: вкусным
генетически: генетически
ждать: ждал
общий: общим
сгрызть: сгрыз
продолжать: продолжают
первый: первую
приют: приютам приют
настроение: настроении
состояние: состоянии
охотник: охотники
осень: осенью
примерный: примерно
песня: песню
ваш: вашу вашей ваш
так: так
аппалачский: аппалачской
мнение: мнению
подружиться: подружились
французский: французскому
четвероногий: четвероногих четвероногие четвероного
ведь: ведь
развиваться: развивались
где: где
больший: больше
кто: кого
самый: самых
товар: товаров товар
сородич: сородичами
быть: было быть были
вывести: выведено
отмечать: отмечать отмечают
преданность: преданность
приспособиться: приспособиться
есть: есть
давний: давних
национальный: национальный
неравнодушный: неравнодушный
мочь: могу могут может
этот: этот эта эти эту этих
сам: самому самого самое
четыре: четырех четыре
интеллект: интеллект
запомнить: запомнить
приложение: приложении
друг: друзьями друзей друг другу друга другом
сбор: сбор
амуниция: амуницией
бы: бы
можно: можно
дать: данном
билл: билл
космос: космосе
почтить: почти
немецкий: немецкой
смочь: смог
возразить: возразить
во: во
разлука: разлуку
насилие: насилия
дата: дата
вернуться: вернувшегося вернувшиеся
решиться: решиться
того: того
остаток: остатками
вы: вас вы вами
оставить: оставил оставьте
фестиваль: фестиваля
номинация: номинации
цель: цель
давно: давно
россия: россии
простой: простые
стоянка: стоянок
свой: своей
обучить: обучены
побаловать: побалуйте
свое: своего своим
популярный: популярными
январь: января
чтобы: чтобы
послушный: послушными
без: без
сайт: сайте
между: между
до: до
взаимоотношение: взаимоотношений
гармоничный: гармоничных
ежедневный: ежедневная
адрес: адрес
другой: других другим
оставаться: остаются
давать: дают
эмоция: эмоции
ее: ее
песик: песиков песика
терапия: терапии
пока: пока
психологический: психологическую
праздник: праздник праздника
число: числе
кличка: кличке
факт: факты
же: же
постепенный: постепенное
горный: горный
всегда: всегда
километр: километров
замечательный: замечательный
что: что чем
поблагодарить: поблагодарить
за: за
домашние: домашних домашние
детская: детских
домашний: домашнему
форма: формами
дом: дом
ожидать: ожидают
настоящее: настоящее настоящие
существовать: существующим существует
если: если
современный: современные современных
великобритания: великобритании
хозяин: хозяин хозяином
повод: повод
традиционно: традиционно
организм: организме
отношение: отношение
из: из
посвятить: посвящённые
бездомный: бездомных бездомным
подсчитать: подсчитать
мировой: мирового
наш: нашим наша
ответственный: ответственное
удобный: удобной
отпечаток: отпечатки
их: их
приручить: приручил
над: над
заказ: заказ
устраивать: устраивают
около: около
оказывать: оказывать
сделать: сделаете сделать
различный: различным
заметить: заметив
точный: точное
святой: святой
колин: колин
разный: разных
верный: верными
здоровый: здоровой
будущее: будущих
год: год лет году года
кто-то: кого-то
пес: пса псов
собака: собаки собак собаке собакам собака собаку собаками
международный: международный международного
лечение: лечении
забота: забота
слабовидящий: слабовидящим
который: который которых которые которым которого
постоянный: постоянное
покровитель: покровитель
волк: волки
любимец: любимца
воспитывать: воспитывающие
выбрать: выбранный
вот: вот
сегодня: сегодня
страна: странах
масштаб: масштаба
помощник: помощниками
случай: случае
радость: радость
цифра: цифра
деть: день
полноценный: полноценной
палец: пальцев
несколько: несколько
питомец: питомцев питомец питомца питомцах
успешный: успешно
миссия: миссия
решение: решения
благодаря: благодаря
мы: мы
фонд: фонда фондов фондам
на: на
тот: том то
не: не
преданный: преданными преданному преданным
каждый: каждый
сложно: сложно
организация: организациях
указать: укажите
премия: премии
любитель: любители любителей
одомашнивание: одомашнивание
дарить: дарящие
но: но
почта: почту
побывать: побывавшие
история: история
появление: появления
длить: для
школа: школах
об: об
орган: органах
согласно: согласно
нет: нет
терпеливо: терпеливо
худой: хуже
он: он
тысяча: тысяч
даже: даже
от: от
нарядный: нарядных
статистика: статистике
установление: установление
первое: первого первые первым
как: как
инициатива: инициатив
внимание: внимание внимания
турист: турист
все: всему
условие: условиям
помогать: помогают помогает
насчитываться: насчитывается
ирвин: ирвин
по: по
поисковый: поисковых
изменяться: изменяющимся
уникальный: уникальны
присутствие: присутствие
миллион: миллионов миллиона
способ: способ
какой: каким каком
сообщество: сообщество
наличие: наличии
боливия: боливии
аксессуар: аксессуаров
произойти: произошло произошли
переть: при
