новый: новый нового
патология: патологиях патологии
найти: найти
текстура: текстурой текстурами текстур текстуры
еще: еще
учет: учетом
рот: рта
физический: физическая
гамма: гамме
включение: включение
воды: воды
пить: пить
менее: менее
важный: важно
доступ: доступе
расстройство: расстройства
помощь: помощью
затруднение: затруднения
а: а
дополнительно: дополнительно
вода: водой
в: в
заболевание: заболеваний заболевания заболеваниям
соответствовать: соответствуют
содержание: содержание содержания содержанию
и: и
качественный: качественный
к: к
вероятность: вероятность
с: с
сейчас: сейчас
у: у
течение: течение
десна: деснами
они: они них им
пищевой: пищевой пищевых
владелец: владельцам владелец
природа: природе
обеспечить: обеспечить
возникновение: возникновения
гигиена: гигиены
необходимый: необходимые
этап: этапе
расположить: расположить
калория: калорий
обосновать: обоснованы
употребление: употребление употребления
время: время
загрязнение: загрязнение
поощрение: поощрения
посмотреть: посмотреть
посоветоваться: посоветоваться
кормление: кормлении кормление кормлением кормления
ранее: ранее
проблема: проблемы проблему
предпочтенье: предпочтений
также: также
корма: корма корм
чистый: чистую чистая
появиться: появится
получение: получения
прежде: прежде
оставлять: оставлять оставляет
поддержание: поддержания
следовать: следует
час: час
прием: приема
написать: напишем
зубной: зубным зубной
зависимость: зависимости
употреблять: употребляет употребляют
обеспечивать: обеспечивают
подбирать: подбирайте подбирать
уменьшить: уменьшить уменьшит
требоваться: требуется
однако: однако
калорийность: калорийность
счет: счет
распорядок: распорядка
рекомендоваться: рекомендуется
система: системы
изменить: изменить
отказ: отказа
рекомендовать: рекомендуемый рекомендуемой рекомендуем
неполный: неполным неполный
отзыв: отзыв
потребность: потребностям потребностей
посоветовать: посоветовать
съедать: съедая съедает
постепенно: постепенно
соус: соусе
доступно: доступно
один: одной один одного одним одно
оценка: оценки
смесь: смесь
иметь: имеет
снизить: снизить снизите
мочить: мочи
мера: мере
оценить: оценить оцените
расчет: расчетом
часть: часть
активность: активности
часто: часто
некоторые: некоторых некоторые
сочетаться: сочетались
помочь: помочь
рассчитывать: рассчитывать
бренд: бренда брендом
помимо: помимо
подсчет: подсчете
тереть: три
поедать: поедать
желательно: желательно
кожа: кожа
делать: делать
комфортный: комфортный
предотвращать: предотвращают
преимущество: преимуществ преимущества
качество: качества качестве
через: через
порча: порчи
взрослый: взрослых
подойти: подойдет
врач: врач врачу врачом
становиться: становится
нравиться: нравится
добавлять: добавлять
большой: большого большое
являться: являются
бывать: бывает бывают
получать: получает
животное: животного животных животным животное
сравнение: сравнению сравнении
жидкий: жидкую
временить: времени
чрезмерный: чрезмерно
поверх: поверх
обладать: обладают
стать: стать
нужно: нужно
интерес: интереса интерес
отличный: отличное
нежный: нежной
питаться: питается
порция: порцию
это: это этого этому
поддерживать: поддерживают поддерживать
большинство: большинстве
равный: равно
вкус: вкусов вкус
рост: роста
два: двух
молодая: молодых
дрессировка: дрессировки
стоить: стоит
его: его
улучшать: улучшают
диагностировать: диагностированы
только: только
менять: менять
диабет: диабета
разнообразие: разнообразие разнообразия
линька: линька линьки
или: или
отличие: отличие
питьевой: питьевом питьевой питьевую
относиться: относящиеся относились относиться
энергетический: энергетическую
особый: особых
хороший: лучше
столь: столь
комбинирование: комбинирование
увлажнять: увлажнять
много: более
добавить: добавить
несъеденный: несъеденные
когда: когда
профилактика: профилактике профилактики
учитывать: учитывайте учитывать
нарушение: нарушениям
потреблять: потреблять потребляет потребляемой
болезнь: болезням болезнь болезни
смешанный: смешанного смешанное смешанном
вещество: веществ
расставить: расставить
одинаковый: одинаковых
состояние: состоянием
норма: норму нормами нормы норм
приобрести: приобрести
иссушаться: иссушается
происхождение: происхождением
стимулировать: стимулировать
игра: игр
поскольку: поскольку
произвести: произведены
переход: переход
высота: высоте
ваш: ваш вашей
именно: именно
ротовой: ротовой
так: так
рекомендация: рекомендации
ведь: ведь
возникнуть: возникли
больший: больше
мыть: мойте мыть
перевести: перевести
полость: полости полость
позволять: позволяет
неделя: недели
самый: самым
материал: материалов
чувствительный: чувствительными чувствительная
товар: товар
выбирать: выбирать
быть: быть были будет
диаметр: диаметру
перемена: перемен
исходить: исходя
достаточный: достаточное
нагрузка: нагрузка
есть: есть
внимательно: внимательно
установить: установить
ряд: рядом
увлажнить: увлажнить
мочь: могут может
попадать: попадал
этот: этой
пищеварительный: пищеварительной
сам: сами
объем: объем объема
друг: друг другом
проявлять: проявляет
схема: схему
кошка: кошек кошка кошки кошкой
ознакомиться: ознакомьтесь
стресс: стрессов
можно: можно
основное: основное
дать: дайте
сочетать: сочетать сочетая
камень: камней
смочь: сможете сможет
утилизировать: утилизировать
аппетит: аппетит
во: во
вес: вес
ценность: ценность
уже: уже
извинить: извините
раз: раза раз
поэтапный: поэтапного
того: того
суточный: суточное суточную суточной
вы: вы вас
остаток: остатки
прошествие: прошествии
оставить: оставьте
образование: образования
пожалуйста: пожалуйста
необходимо: необходимо
версия: версий
потребление: потребление потребления потреблению
адаптировать: адаптировать
диетолог: диетологу
обычно: обычно
свое: своего
тем: тем
чтобы: чтобы
рацион: рациона рационе рационы рацион рационов рационами рационом рациону
пара: парой
энергия: энергии
привередливый: привередливый
дома: дома
правильно: правильно
до: до
полезный: полезны
увеличить: увеличите увеличить
особенность: особенностей
адрес: адрес
представить: представлены
другой: другим других
характеристика: характеристик
давать: давайте давать
введение: введении
побуждать: побуждает
ее: ее
пожилой: пожилых
регулярно: регулярно
избыточный: избыточный
сухой: сухими сухие сухих сухого сухой сухим
питание: питание питания
число: числе
разбавление: разбавлению
знать: знать
причина: причин причиной
порекомендовать: порекомендуем
кроме: кроме
влага: влаги
выяснить: выяснили
же: же
польза: пользой пользы
пустынный: пустынным
подход: подхода
плотный: плотных
отдельность: отдельности
оба: оба обоих
путь: путей
что: чем что
четкий: четкого
зуб: зубами
цистит: цистита
править: правило правила
за: за
тип: типов
котенок: котенок
уменьшать: уменьшаете уменьшайте
дом: дому
ожидать: ожидают
показатель: показатель
максимальный: максимальной
свободный: свободном
лакомство: лакомства
набор: набором набор
статья: статье
если: если
существовать: существуют
соответственно: соответственно
поддержать: поддержать
кусочек: кусочки кусочками кусочков
отличаться: отличающихся
из: из
сахарный: сахарного
ветеринарный: ветеринарный ветеринарному ветеринарным
их: их
многие: многих многим
заказ: заказ
следить: следить
различный: различным различных
связанный: связано
мочекаменный: мочекаменная мочекаменной
здоровье: здоровья здоровье
влажный: влажные влажной влажных влажными влажный влажного
удовлетворение: удовлетворения
разный: разными разные
здоровый: здоровый здоровым здоровых
будущее: будущем
ежедневно: ежедневно
жидкость: жидкости
гранула: гранулы гранул
обратиться: обратитесь
собака: собак собаки собака
упаковка: упаковке
приходиться: приходится
безопасность: безопасности
решить: решить
повседневный: повседневное
который: которые которых которое котором
поэтому: поэтому
легкий: легче
расстояние: расстоянии
например: например
любимец: любимец
следующий: следующих
ли: ли
пища: пище пищи
привести: привести приведенную
крайний: крайней
выбрать: выбрать выбрали
рассказать: расскажем
страх: страха
повышенный: повышенный
случай: случаев случае
сразу: сразу
создать: созданные
такой: такие таких такую таким такое таком
плюс: плюсы
деть: день
отравление: отравлению
смесить: смеси
загрязнять: загрязнял
вод: воде воду вода
нужный: нужны
несколько: несколько несколькими
питомец: питомцу питомцам питомцев питомец питомца
вкусовой: вкусовые
отдельно: отдельно
избирательность: избирательность
место: места
решение: решение
располагаться: располагаются
собираться: собираетесь
горазд: гораздо
благодаря: благодаря
мы: мы
крайне: крайне
на: на
свежий: свежая
тот: то том
не: не
использовать: использовать используйте
каждый: каждый
эластичный: эластичной
указать: укажите
содержать: содержат
миска: мисках миски миске миску мисок
маленький: меньше
но: но
стерилизовать: стерилизованных
почта: почту
желе: желе
полезно: полезно
привычный: привычному
обеспечение: обеспечения
таблица: таблицей
длить: для
дважды: дважды
количество: количество количества
питательный: питательных
уровень: уровень
влияние: влияние
приблизительно: приблизительно
нет: нет
корм: кормов кормом
интенсивный: интенсивная интенсивной
развитие: развитие развития
он: он ему
предлагать: предлагайте
даже: даже
от: от
мочевыводящий: мочевыводящих
придерживаться: придерживаться придерживаясь
способствовать: способствуют способствует
попробовать: попробовать
недостаточный: недостаточное недостаточный недостаточного недостаточному
как: как
помять: помните
все: все всему
низкий: низкому ниже
условие: условиях
помогать: помогают помогает помогая
возможность: возможности
по: по
рецидив: рецидива
безопасный: безопасных
склонный: склонным склонны склонных
достижение: достижения
соотношение: соотношения
ожирение: ожирения
фонтанчик: фонтанчике фонтанчик
риск: риск
способ: способами способа способ
отражаться: отражается
высокий: высокое
какой: какой каким
линейка: линейке
наличие: наличии
продукт: продукты продукта продуктов
захватывать: захватывать
переть: при
источник: источником
