стандартный: стандартные
дозировка: дозировку
день: дней
представлять: представляет
ряд: ряде
отечественный: отечественным
мочь: может
этот: этой этот
важный: важно важное
друг: другом
юридический: юридический
вирусный: вирусных вирусной
включаться: включаются
а: а
многократный: многократные
б: б
в: в
заболевание: заболеваний
иммунитет: иммунитет
помещение: помещение
реклама: реклама
содержание: содержание
ветеринария: ветеринарии
схема: схемы
кошка: кошек кошки
и: и
терапевтический: терапевтическую
применение: применения
рекламодатель: рекламодатель
можно: можно
о: о
основное: основное
с: с
исследование: исследования
средство: средство средствами
у: у
действовать: действующее
применять: применять
течение: течение течении
область: область
использоваться: используются используется
они: они
производитель: производитель
пищевой: пищевая
наступать: наступает
диагноз: диагноз
ценность: ценность
уже: уже
извинить: извините
больной: больных
раз: раза
единица: единиц
вы: вы
оставить: оставьте
доказать: доказано доказали
клинический: клиническая клинические
соблюдать: соблюдать
побочный: побочные
россия: россии
разрушать: разрушает
бесцветный: бесцветную
ооо: ооо
ветврач: ветврачами
токсический: токсического
раствор: раствора
также: также
интервал: интервалом
появиться: появится
получение: получения
написать: напишем
адрес: адрес
представить: представлено
другой: другими
света: света
инна: инн
собственный: собственный
схожий: схожа
сухой: сухом
посол: после
себя: собой
профилактический: профилактической
часы: часов
офис: офис
число: числе
тяжелый: тяжелом
рекомендовать: рекомендуем
отзыв: отзыв
днк: днк
оценка: оценки
иметь: имеет
выздоровление: выздоровление
свойство: свойствами
что: что
мера: меры
оценить: оцените
домашний: домашнего
форма: форме
ожидать: ожидают
московский: московская
активность: активностью
часто: часто
этиология: этиологий
некоторые: некоторых
применяться: применяется
статья: статье
частый: частые
инфекция: инфекций
любой: любых
подвести: подведем
организм: организм
инъекция: инъекций
ветеринарный: ветеринарными ветеринарный ветеринарным
производить: производят
видимый: видимое
бактериальный: бактериальных
качество: качестве
преимущество: преимущества
заказ: заказ
зачастую: зачастую
доза: дозы дозу
внутримышечный: внутримышечных
врач: врачами врач врачом
назначить: назначенную
поставить: поставить
назначать: назначают назначайте
верный: верный
являться: является
животное: животного
защитить: защищенном
непрерывный: непрерывном
жидкость: жидкость
увеличивать: увеличивают
лечение: лечения лечении
международный: международных
обладать: обладает
инфекционный: инфекционных
холодильник: холодильнике
передовой: передовое
картина: картина
следующий: следующих
это: это
гудков: гудкова
прямой: прямое
рассказать: расскажем
случай: случаев случаях
температура: температуре
такой: такие
эффект: эффект
только: только
двойной: двойное
храниться: хранится
питомец: питомцам питомцу питомцев
средний: среднюю
место: месте
вирус: вируса
или: или
лекарственный: лекарственные лекарственное лекарственными
возраст: возрастов
противопоказание: противопоказания
мы: мы
точно: точно
утверждать: утверждает
на: на
состав: состав составе
воздействие: воздействия
комплекс: комплексе
тот: том
использовать: используют
не: не
самостоятельно: самостоятельно
каждый: каждая
указать: укажите
быстрый: быстрее
почта: почту
выпускаться: выпускается
когда: когда
профилактика: профилактики
значит: значит
болезный: болезней
длить: для
замести: заметен
об: об
активировать: активируя
действие: действие действия
нет: нет
болезнь: болезни болезнях
смешанный: смешанных смешанной
вещество: вещество
состояние: состояния
от: от
итог: итоги
вопрос: вопросы
слышать: слышали
как: как
первое: первым первого
препарат: препарате препараты препарат препарата препаратом
условие: условие
ваш: вашей ваш
ответ: ответы
где: где
противовирусный: противовирусной противовирусное
жуковский: жуковский
порода: пород
улучшение: улучшение
способ: способ
товар: товар
какой: каких
наличие: наличии
переть: при
