долгий: долго
специальный: специальные специальных
эфирный: эфирные
раздражение: раздражения
новый: новых
день: дня дней
таблетка: таблеток
прогулка: прогулки
происходить: происходит
еще: еще
подцепить: подцепить
эффективный: эффективно эффективна
любимица: любимицу
делиться: делятся
менее: менее
важный: важно важна
доступ: доступа
под: под
стирать: стирать
нести: несущие
помощь: помощью
жертва: жертву
смочить: смоченный
а: а
человек: человека
вода: водой
в: в
заболевание: заболевания заболеванием
помещение: помещений помещениях помещения
содержание: содержание
лес: лесу
и: и
к: к
подходить: подходящее подходят подходит подходящий
о: о
переносчик: переносчиками
с: с
она: ей
средство: средства средство средств
у: у
новорожденная: новорожденных
применять: применяют
определить: определить
шампунь: шампуни шампуня шампуней
течение: течение
область: области
клещ: клещи клещей клещ клеща
они: них им они ими
оно: оно
пройти: прошла
необходимый: необходимая
раздвинуть: раздвиньте
входить: входят
кормить: кормящим кормящая кормящих
небольшой: небольшое
время: время
ранее: ранее
сильный: сильный
также: также
обитать: обитают
появиться: появилось появится
город: городу
получение: получения
понравиться: понравился
следовать: следует
погибнуть: погибших
комплексный: комплексным
предварительно: предварительно
написать: напишем
трава: трава
сначала: сначала
вред: вреда
света: свет
симптом: симптомы
периодичность: периодичность
высушить: высушить
уничтожение: уничтожения
показать: показать
гребень: гребня
накапливаться: накапливается
дискомфорт: дискомфорт
отсутствие: отсутствия
подбирать: подбирайте подбирать
аллергический: аллергической аллергическую
однако: однако
часы: часов
рекомендоваться: рекомендуется
ядовитый: ядовитые
рекомендовать: рекомендованное рекомендуем
отзыв: отзыв
допускаться: допускаются
сальный: сальных
отлучение: отлучение
один: одного одно
повреждение: повреждений
оценка: оценки
иметь: имеет имеют имеющая
совет: советы
полностью: полностью
выждать: выждать
мера: меры
пользоваться: пользоваться
оценить: оцените
лишь: лишь
выход: выхода
инструкция: инструкции инструкцией
некоторый: некоторое
некоторые: некоторые
помочь: поможет помочь
труд: трудом
укус: укусы укусе
обувь: обуви
тереть: три
процесс: процессе
лопатка: лопаток
расчесать: расчесанном
способный: способно способны
кожа: коже кожа кожи
делать: делает делать
уборка: уборка
ошибочно: ошибочно
обнаружение: обнаружения
среди: среди
градус: градусов
клетчатка: клетчатке
грудной: грудное
шея: шеи
качество: качестве
через: через
пудра: пудру
взрослый: взрослых взрослой взрослую
дерматит: дерматиты
спина: спины
врач: врачу врач врача
нравиться: нравятся
результат: результате
доставлять: доставляют
осторожный: осторожным
особенно: особенно
большой: большое
выделяться: выделяется
являться: являются
животное: животного животном животных животное
плацентарный: плацентарный
временить: времени
угроза: угрозу
инсектицид: инсектициды инсектицидов инсектицида инсектицид
достаточно: достаточно
обладать: обладающие обладают
нужно: нужно
стать: станет
нестерпимый: нестерпимый
возможно: возможно
вызывать: вызывают
провести: провести
группа: группы
переносить: переносят
обработка: обработку обработки обработке обработка
это: это этом
большинство: большинство
распылить: распылить
два: две
ошейник: ошейники ошейник ошейника ошейников
вполне: вполне
консультация: консультацией
его: его
иметься: имеющихся
эффект: эффектом
анемия: анемию
только: только
сантиметр: см
ветеринар: ветеринаром ветеринару
язвочка: язвочки
капля: капель капли каплей каплями
пипетка: пипетки
нельзя: нельзя
покров: покровах
избавлять: избавляют
улица: улицу улице
заражение: заражение заражения заражению
или: или
трогать: трогать
отличие: отличие
возраст: возраста возраст возрасте
чаща: чаще
причем: причем
защита: защиты защита
теплый: теплых
минимум: минимум
особый: особей
хороший: лучшая
слизать: слизать
подхватить: подхватить
когда: когда
учитывать: учитывать учитывая
болезный: болезней
страдать: страдает
обычный: обычной
затем: затем
присыпка: присыпок присыпку
действие: действия действием
чувствительность: чувствительность
болезнь: болезнями
дача: даче
разрешить: разрешено разрешены
вещество: вещества вещество
масса: массе
заразиться: заразиться заразится заразилась
состояние: состояние состояния
всасываться: всасывается
игра: игры
размер: размерах
ваш: вашей ваш
так: так
старший: старше
мнение: мнение
четвероногий: четвероногий
подразделяться: подразделяются
ведь: ведь
где: где
больший: больше
мыть: мыть
промыть: промыть
активный: активны
реакция: реакции реакцию
использование: использованием использование использования
неделя: недели
материал: материалов
товар: товар
выбирать: выбирая
быть: будет быть
шерсть: шерсть
вывести: вывести
одеть: одеть
исходить: исходя
дозировка: дозировка
есть: есть
кровососущий: кровососущих
район: районе
ряд: ряд
покраснение: покраснений
мочь: могут может
месяц: месяцев месяца
этот: эти этот эта этой
сам: самой
потомство: потомству
убивать: убивают
покусать: покусать
иммунитет: иммунитетом иммунитета
смыть: смыть
гельминт: гельминтов
кошка: кошки кошек кошку кошка кошке
впиться: впиться
ознакомиться: ознакомьтесь
летальный: летальному
можно: можно
применение: применением применение применения применению
дать: данных
болезненный: болезненны
действовать: действующее действующий действовать действующие
минимальный: минимальное
подстилка: подстилку
использоваться: используются
гарантия: гарантия
во: во
вес: вес веса
своевременный: своевременную своевременная
уже: уже
снижение: снижение
извинить: извините
фирменный: фирменной
раз: раза
барьер: барьер
того: того
вы: вы
оставить: оставить оставьте
смертельный: смертельно
проводить: проводить
исход: исходу
необходимо: необходимо
дерево: деревья
просто: просто
регулярный: регулярная
тест: тест
сутки: суток
устранять: устраняют
свое: свои
убедиться: убедиться
тем: тем
чтобы: чтобы
густой: густой
рана: раны
противопаразитарный: противопаразитарная
пах: паха
перед: перед
предупреждать: предупреждают
шерстить: шерсти
до: до
погибать: погибают
мытье: мытья
ежедневный: ежедневная
адрес: адрес
другой: другие других
отпугивать: отпугивают
осмотр: осмотра
введение: введение
ее: ее
ослабить: ослабленным
пожилой: пожилую
регулярно: регулярно
запретить: запрещено
посол: после
запрещаться: запрещается
профилактический: профилактической профилактическую
вычесывать: вычесывать
задерживаться: задерживаются
шелушение: шелушения шелушение
причина: причинам причине
контроль: контролем
вид: виде вид вида виды
вымыть: вымыть
энцефалит: энцефалит
выдавливать: выдавливайте
круглогодичный: круглогодичная
путь: пути
что: чем что
масло: масла
длительный: длительного
подверженный: подвержены
править: правило
зуд: зуд зуда
тип: типу тип
предмет: предметов
за: за
назначаться: назначается
паразит: паразиты паразита паразитов паразитами
указывать: указывают
котенок: котят котятам котенок котенку котенка
форма: форма
вычесать: вычесать
дом: дом
ожидать: ожидают
если: если
протекать: протекает
принцип: принцип
любой: любого любое
осматривать: осматривать
из: из
инъекция: инъекции инъекций
подъезд: подъездах
прекратить: прекратить
ветеринарный: ветеринарному ветеринарный ветеринарного
естественный: естественное
ранний: ранних
их: их
насекомое: насекомых насекомые
заказ: заказ
длинношерстный: длинношерстную
сделать: сделаны сделать
квартира: квартирах
заметить: заметить
здоровье: здоровью здоровья
тело: теле телу тела
нанести: нанести нанесен нанесут
влажный: влажных влажная
разный: разную разное разный
новорожденный: новорожденному
здоровый: здоровых
ежедневно: ежедневно
год: года лет
защитить: защитить
обратиться: обратиться
кустарник: кустарники
упаковка: упаковке
лечение: лечению
ползать: ползать
мать: матери
малыш: малышей малыша малыши
беременная: беременных беременным беременная беременную
прекрасно: прекрасно
который: которые которых которому которую которого
вывод: выводы
поэтому: поэтому
токсичный: токсичны токсичные токсичное
длительность: длительность
холка: холке холки холку
хронический: хроническим
участок: участок
искупать: искупали
расстояние: расстоянии
например: например
сальмонеллез: сальмонеллез
подобрать: подобрать
привести: привести
вещь: вещи вещей
уничтожать: уничтожает уничтожая
поддаваться: поддается
вот: вот
случай: случае
сразу: сразу
напиться: напившийся
температура: температуре
такой: такие такой таких
плюс: плюс
жить: живут
правильный: правильный
нужный: нужного
несколько: нескольких
питомец: питомца питомцам питомец
место: месте места место местах
гладкошерстный: гладкошерстном
безопасно: безопасно
сохраняться: сохраняется
кожный: кожных
натуральный: натуральных натуральные
обиход: обихода
мы: нас мы
ввиду: ввиду
подкожный: подкожное подкожной
на: на
состав: состав
тот: те том
не: не
использовать: использовать
выбор: выборе выбор
образоваться: образуются
самостоятельно: самостоятельно
каждый: каждого
наиболее: наиболее
указать: указанное указана укажите
ни: ни
кровь: крови кровь
содержать: содержащие содержать содержат
но: но
почта: почту
нанесение: нанесения
вызвать: вызвать
выпускаться: выпускаются
ношение: ношение
появление: появление появления
длить: для
категория: категории
обрабатывать: обрабатывать
начинать: начинают начинать
количество: количество
увеличиваться: увеличивается
личинка: личинки
либо: либо
принести: принести
перепрыгнуть: перепрыгнуть
даже: даже
от: от
предельно: предельно
железо: железах
блоха: блохи блох блохами блоха блоху
как: как
все: всего все
препарат: препараты препарат препарата
бессимптомный: бессимптомно
по: по
молоко: молоко
подмышка: подмышек
проникнуть: проникнет
стадий: стадиях
безопасный: безопасными
информация: информация
достижение: достижения
самка: самок самкам
комбинированный: комбинированные
опасный: опасные опасны опасных
шерстка: шерстки
одежда: одежде
подбираться: подбирается
проникать: проникать
разгрызть: разгрызть
порода: породу
способ: способ
высокий: выше
наличие: наличие наличии
подбор: подбором
произойти: произошло
переть: при
