приводить: приводит
стандартный: стандартных
водостойкий: водостойкий
комар: комаров
слабительный: слабительное
таблетка: таблетках таблеток таблетки таблетке таблетку таблетка
образ: образа
прогулка: прогулку
еще: еще
ребенок: дети детей
эффективный: эффективен
воды: воды
делиться: делится
промаркировать: промаркированы
касаться: касается
под: под
юридический: юридический
а: а
человек: человека
б: б
в: в
заболевание: заболеваний
помещение: помещение
реклама: реклама
содержание: содержание
выводить: выводит
и: и
охотничий: охотничьих
к: к
о: о
вероятность: вероятность
с: с
она: она
средство: средства
у: у
применять: применять
лекарство: лекарства
течение: течение
область: область
они: них они
дополнительный: дополнительные
сезон: сезона
клещ: клещи клещей
земля: земли
внутриутробный: внутриутробно
диагноз: диагноза
конкретный: конкретно
блистер: блистер
входить: входят
кормить: кормящим кормящих
медучреждение: медучреждение
небольшой: небольшим
время: время
прописывать: прописывают
быстро: быстро
весной: весной
деполяризация: деполяризацию
разрушать: разрушает
ооо: ооо
внутренний: внутренних
выходить: выходящими выходящие выходят
сердечная: сердечных сердечными
подробно: подробно
кормление: кормления
проблема: проблему
составлять: составляет
капиллярный: капиллярную
также: также
корма: корма
интервал: интервалом
обитать: обитающими
индивидуальный: индивидуальная
появиться: появится
получение: получения
следовать: следует
легко: легко
написать: напишем
научный: научного
находиться: находится
вложить: вложены
окончание: окончания
периодичность: периодичность
увидеть: увидите
окончательный: окончательной
мускулатура: мускулатуру
розничный: розничных розничном
обеспечивать: обеспечивает
инна: инн
подбирать: подбирающие подбирают
уменьшить: уменьшить
требоваться: требуются
повышать: повышает
целлюлоза: целлюлоза
себя: собой
офис: офис
рекомендоваться: рекомендуется рекомендуются
голодный: голодной
черви: червей червями
однородный: однородными
случайно: случайно
объясняться: объясняется
рекомендовать: рекомендован рекомендуемые рекомендуем
отзыв: отзыв
заражаться: заражаются
один: один одной одну одна одного
оценка: оценки
иметь: имеют имеет
совет: совета
собачка: собачкам собачке
хлор: хлора
расчет: расчете
оценить: оцените
часть: часть
практический: практически
последний: последнюю
московский: московская
активность: активность
повреждать: повреждая
инструкция: инструкции инструкцию
москит: москитов
часто: часто
лето: летом
обезопасить: обезопасить
помочь: помогут поможет
микрокристаллический: микрокристаллическая
обувь: обуви
укус: укусов
инфекция: инфекций
целовать: целую
тереть: три
описание: описание
недостаток: недостатков
подстерегать: подстерегают
делать: делает
продвижение: продвижение
парализовать: парализует
обнаружение: обнаружении обнаружения
ежемесячно: ежемесячно
хранить: хранить
градус: градусов
среди: среди
предотвращать: предотвращать
качество: качестве
преимущество: преимущества
через: через
воспользоваться: воспользоваться
гладкий: гладкими
взрослый: взрослым взрослых
врач: врачом врача
отдельный: отдельных
рынок: рынке
штука: штуки
являться: является
животное: животного животными животные животных животным
ничего: ничего
увеличивать: увеличивает
эффективность: эффективность
весомый: весом
различаться: различается
решать: решает решать
половина: половину
нужно: нужно
обладать: обладают
возможно: возможно
вызывать: вызывает
группа: группе
обработка: обработки обработок обработку обработка
это: этом это этого
прочный: прочными
ткань: ткани
два: два двух
ошейник: ошейник
удобство: удобство
кой: коем
замедлять: замедляет
взять: взять
стабильность: стабильность
его: его
улучшать: улучшает
эффект: эффектов эффектом эффект эффекты
жизнь: жизни
только: только
остальное: остальном
дегельминтизация: дегельминтизации
ветеринар: ветеринаром
капля: капли
эхинококк: эхинококки
нельзя: нельзя
улица: улицу улицы
заражение: заражения заражение заражениях
или: или
далеко: далеко
наклейка: наклейки
возраст: возраст
относиться: относятся
буква: буквы
особый: особей
хороший: лучше
много: более много
когда: когда
профилактика: профилактики
рассчитать: рассчитаны рассчитана
ссать: сса
ленточный: ленточными
затем: затем
натрий: натрия
нарушение: нарушении
овальный: овальные
действие: действия
болезнь: болезни
первый: первой
разрешить: разрешен разрешены
вещество: веществ
норма: нормой
осень: осенью
отметка: отметок
клеточный: клеточных
лактоза: лактозы
луч: лучей
наблюдаться: наблюдаться
компания: компанией
мембрана: мембран
ориентироваться: ориентироваться ориентируйтесь
паралич: параличу
размер: размер
наблюдение: наблюдением
сохранять: сохраняет
против: против
ваш: вашей ваш
так: так
прибегать: прибегать
разов: разовой
рекомендация: рекомендации
ведь: ведь
больший: большим
срок: срок
промыть: промыть
активный: активных
использование: использованию использования
неделя: неделю
самый: самым
товар: товар
европейский: европейского
быть: будете будет
истечь: истек
мышечный: мышечной
яйцо: яйца
дозировка: дозировке дозировки
есть: есть
пахнуть: пахнет
спутать: спутать
внимательно: внимательно
франция: франции
мочь: может могут
месяц: месяц месяца месяцев
этот: этой
сам: сами
борьба: борьбе
недоступный: недоступном
вскрыть: вскрыт
личиночный: личиночной
гельминт: гельминта гельминтов гельминтами
кошка: кошек
терапевтический: терапевтической
прочитать: прочитайте
можно: можно
применение: применением применению применения
рекламодатель: рекламодатель
отнести: отнести
дать: дать дали данным
действовать: действующих действовать действует
аудит: аудит
этикетка: этикетку
во: во
вес: вес весе
пополам: пополам
уже: уже
хранение: хранения
извинить: извините
раз: раза
того: того
вы: вы вам
ежемесячный: ежемесячную
оставить: оставьте
смертельный: смертельно
проводить: проводить
солнечный: солнечных
паспорт: паспорте
необходимо: необходимо
побочный: побочных побочные
снижать: снижает
оболочка: оболочку
россия: россии
тест: тесты
щенок: щенкам щенков щенки
сокращать: сокращает
ветврач: ветврача
тем: тем
здесь: здесь
нематода: нематодами
контактировать: контактирует
проведение: проведения проведении
перед: перед
дома: дома
до: до
желудочный: желудочному
положить: положите
руководство: руководства
мелкий: мелких
годность: годности
адрес: адрес
другой: другими другой другие
клетка: клеток
колли: колли
ионов: ионов
давать: давать давали
магний: магния
ее: ее
проконсультироваться: проконсультироваться проконсультируйтесь
посол: после
питание: питания
период: период
защищать: защищают
усиливать: усиливает
причина: причиной
беременность: беременности
вид: видов
же: же
подход: подход
вымыть: вымойте
всегда: всегда
попасть: попала
моногидрат: моногидрат
что: что
за: за
паразит: паразитов паразитам паразитами
спектр: спектр
форма: формах форме формы форма
ожидать: ожидают
зависеть: зависит
применяться: применяются
даваться: дается
обрабатываться: обрабатываются
статья: статье
справляться: справляется
стеарат: стеарат
если: если
хозяин: хозяин
любой: любой
отличаться: отличаются
организм: организма организме
из: из
ветеринарный: ветеринарным ветеринарного ветеринарном
распад: распада
случайный: случайном
ранний: ранней
удобный: удобная удобный
их: их
компонент: компонента компонентов компоненты
язык: языка
заказ: заказ
доза: дозы дозе
тщательно: тщательно
сделать: сделать
диета: диете
проницаемость: проницаемостью проницаемость
разный: разные разных разный
верный: верно
проглотить: проглотить проглотит
год: год лет года
кг: кг
истощить: истощенным
защитить: защитит
обратиться: обратиться
собака: собак собакам собаки собака собаке собаку
закинуть: закинуть
упаковка: упаковке упаковку
лечение: лечения
кальций: кальция
круглый: круглые круглых круглыми
безопасность: безопасность
беременная: беременным беременных
вывод: выводу выводы
который: которых которые который
поэтому: поэтому
холка: холку
крупный: крупных
например: например
следующий: следующие
гудков: гудкова
ли: ли
привести: приведены
сопутствовать: сопутствующих
промежуток: промежуток
непереносимость: непереносимость
выбрать: выбрать
рассказать: расскажем
повышенный: повышенной
случай: случае
сразу: сразу
температура: температуре
такой: таких
плюс: плюсов
питомец: питомцам питомцев питомца питомец
начало: начала
место: месте место
тракт: тракту
никакой: никаких
рука: руки
корень: корень
широкий: широкий
мы: мы
слизистая: слизистые
на: на
состав: состав
тот: то те
глаз: глаза
не: не
использовать: использовать
выбор: выборе
каждый: каждый
сложно: сложно
ни: ни
указать: укажите
частить: части
содержать: содержит
ускорять: ускоряет
охотиться: охотятся
но: но
маленький: маленьким маленькой
почта: почту
выпускаться: выпускается
появление: появление
длить: для
гибель: гибели
обрабатывать: обрабатывать
муха: мух
количество: количество количеством
об: об
личинка: личинок
механизм: механизм
принести: принес
растворение: растворения
согласно: согласно
нет: нет
корм: кормов
он: он него
треть: треть
даже: даже
показание: показания
анкилостома: анкилостома
от: от
соединение: соединений
способствовать: способствует
блоха: блохи блох
как: как
первое: первых первом первое
помять: помните
все: всех всего
препарат: препараты препарате препарат препарата
низкий: ниже
глист: глистов глиста глисты
условие: условия условии условий
помогать: помогает
продажа: продаж продажам
проглатывание: проглатывании
по: по
защитный: защитную
стадий: стадии
выпуск: выпуска
занимать: занимает
антигельминтный: антигельминтные
постановка: постановки
прохождение: прохождении
жуковский: жуковский
опасный: опасными
риск: риска
порода: пород породы
способ: способ
высокий: высокую высокая выше
нервный: нервной
какой: какой какие
наличие: наличии
обратный: обратно
второе: вторых втором
аксессуар: аксессуар
продукт: продуктами продуктов
переть: при
второй: вторую
